contig	start	stop	name	aCount	bCount	totalCount	log2_aFC	subject	samp
15	85923802	86292586	ENSG00000170776.15	1043	792	1835	0.39716682244	SG042	S60
12	68383225	68628466	ENSG00000255733.1	19	53	72	-1.47999294112	SG027	S22
1	16944751	16961054	ENSG00000215908.5	97	32	129	1.5999128421899995	SG037	S54
2	242673994	242708226	ENSG00000180902.12	138	210	348	-0.6057210608879999	SG040	S50
21	46305868	46351904	ENSG00000160255.12	1004	670	1674	0.583526268606	SG039	S74
16	11773016	11830089	ENSG00000153066.8	20	56	76	-1.4854268271700002	SG025	S10
X	152713124	152760978	ENSG00000213397.6	24	2	26	3.58496250072	SG022	S11
15	63900817	64126141	ENSG00000103657.9	160	226	386	-0.498250867528	SG043	S62
3	45596886	45727830	ENSG00000144791.5	317	422	739	-0.412760158568	SG040	S50
7	128577666	128590089	ENSG00000128604.14	265	190	455	0.47999294112	SG043	S62
17	40253422	40264751	ENSG00000108771.8	136	49	185	1.47275299714	SG024	S13
1	150702672	150738433	ENSG00000163131.6	285	404	689	-0.5033933736999999	SG155	S41
20	60962172	60963576	ENSG00000171858.13	41	7	48	2.55019708256	SG027	S22
19	41903385	41930910	ENSG00000248098.6	178	79	257	1.17195268279	SG021	S15
22	42321045	42322822	ENSG00000159958.3	362	276	638	0.391321430305	SG152	S68
6	25963030	25987384	ENSG00000112343.8	8	41	49	-2.35755200462	SG044	S63
22	45064593	45133561	ENSG00000186654.16	9	43	52	-2.25633975326	SG002	S7
11	124932963	124958376	ENSG00000134955.7	151	231	382	-0.613344302091	SG002	S31
6	133135580	133138703	ENSG00000112306.7	1020	1191	2211	-0.223604261005	SG026	S18
X	119561682	119603220	ENSG00000005893.11	15	68	83	-2.18057224564	SG003	S27
12	118470712	118500235	ENSG00000176871.4	142	88	230	0.6903155008670001	SG039	S74
16	23847322	24231932	ENSG00000166501.8	261	367	628	-0.491730256273	SG037	S78
21	43916118	44001550	ENSG00000160190.9	272	196	468	0.472752997135	SG069	S24
8	145618458	145634753	ENSG00000071894.10	79	40	119	0.98185265329	SG045	S56
8	144349603	144359101	ENSG00000250571.2	119	184	303	-0.628744192749	SG148	S71
12	113376157	113411054	ENSG00000111331.8	900	1445	2345	-0.683072586171	SG043	S85
1	86115106	86174116	ENSG00000117174.6	19	50	69	-1.3959286763299998	SG040	S73
X	71549366	71792953	ENSG00000147099.15	1	25	26	-4.64385618977	SG031	S95
19	16177831	16213813	ENSG00000167460.10	344	200	544	0.782408564927	SG031	S95
5	131817301	131826490	ENSG00000125347.9	167	239	406	-0.517162515507	SG002	S31
11	2316875	2324279	ENSG00000110665.7	32	0	32	inf	SG041	S59
11	87846410	87908635	ENSG00000123892.7	46	92	138	-1.0	SG040	S49
X	153172821	153193873	ENSG00000089820.11	91	147	238	-0.691877704638	SG044	S63
14	92980118	93155339	ENSG00000100599.11	217	149	366	0.542382711982	SG044	S87
17	79633664	79640934	ENSG00000185298.8	256	163	419	0.651271845769	SG038	S52
4	185261909	185275130	ENSG00000180712.3	71	29	100	1.2917661243799998	SG043	S61
19	1065922	1086593	ENSG00000180448.6	1044	1288	2332	-0.303010881545	SG042	S84
1	150190717	150208504	ENSG00000143401.10	85	42	127	1.0170735133600002	SG152	S70
19	50936160	50969578	ENSG00000086967.9	48	5	53	3.26303440583	SG152	S68
19	36195429	36207940	ENSG00000011590.9	316	440	756	-0.477578965348	SG043	S62
4	39289076	39367995	ENSG00000035928.10	33	99	132	-1.58496250072	SG021	S15
11	75110530	75133324	ENSG00000149273.10	478	587	1065	-0.296349885129	SG030	S43
15	78570177	78592136	ENSG00000140395.4	41	81	122	-0.982297998267	SG045	S79
11	5710919	5757680	ENSG00000132274.11	474	365	839	0.376990595131	SG037	S77
12	9848414	9848823	ENSG00000213443.2	27	8	35	1.75488750216	SG152	S68
17	45810610	45823485	ENSG00000073861.2	4	25	29	-2.64385618977	SG149	S66
2	219135115	219211516	ENSG00000127838.9	28	83	111	-1.5676845092899998	SG002	S31
1	213025450	213031430	ENSG00000198468.3	32	6	38	2.41503749928	SG069	S47
22	36649056	36663576	ENSG00000100342.16	550	407	957	0.434402824146	SG151	S64
3	121350246	121379774	ENSG00000180353.6	836	1117	1953	-0.418054338402	SG155	S42
16	89940014	89977792	ENSG00000141002.14	197	274	471	-0.475980263504	SG024	S36
7	64126511	64171404	ENSG00000196247.7	92	32	124	1.52356195606	SG043	S61
2	228029281	228179508	ENSG00000169031.14	20	91	111	-2.18586654531	SG043	S62
6	43193367	43197222	ENSG00000112667.8	146	80	226	0.8678964639929999	SG151	S88
19	42037566	42038534	ENSG00000268355.1	12	0	12	inf	SG011	S32
19	3750878	3761697	ENSG00000011132.7	169	107	276	0.659412449881	SG042	S60
1	1247058	1260071	ENSG00000127054.14	224	155	379	0.531230516783	SG037	S54
16	70190243	70207224	ENSG00000247228.2	55	107	162	-0.960107272876	SG026	S17
4	2794750	2842825	ENSG00000087266.11	350	442	792	-0.33669144755900005	SG043	S62
10	45869661	45941561	ENSG00000012779.6	248	167	415	0.570492017913	SG045	S56
5	304291	438406	ENSG00000063438.12	712	586	1298	0.280976576544	SG039	S75
19	50922195	50934570	ENSG00000269404.2	169	102	271	0.7284540943109999	SG155	S19
X	134382867	134478012	ENSG00000186376.10	5	33	38	-2.72246602447	SG022	S12
12	121570622	121623876	ENSG00000089041.12	89	49	138	0.861023586851	SG151	S65
X	100264335	100307105	ENSG00000188917.10	53	19	72	1.47999294112	SG003	S3
22	42905974	42915808	ENSG00000189306.6	66	116	182	-0.813586875769	SG041	S58
7	150060866	150068244	ENSG00000240449.1	251	166	417	0.596504122604	SG022	S35
4	38968365	39034542	ENSG00000121895.7	42	15	57	1.4854268271700002	SG006	S28
22	22516592	22517074	ENSG00000211639.2	0	15	15	-inf	SG031	S95
1	62660503	62678000	ENSG00000240563.1	19	1	20	4.2479275134400005	SG041	S59
22	43088127	43117304	ENSG00000128274.11	133	66	199	1.01088831614	SG041	S59
2	89265781	89266286	ENSG00000239855.1	44	2	46	4.45943161864	SG001	S1
X	70279094	70288273	ENSG00000147164.7	14	1	15	3.80735492206	SG046	S80
5	10679342	10761384	ENSG00000112977.11	241	327	568	-0.440257489268	SG031	S23
19	40736224	40791443	ENSG00000105221.12	215	139	354	0.629251776866	SG027	S22
3	40498783	40503861	ENSG00000188846.9	361	207	568	0.8023680693880001	SG148	S94
5	96149731	96271097	ENSG00000247121.2	258	772	1030	-1.5812297818399998	SG148	S71
16	56395364	56459450	ENSG00000159461.10	25	60	85	-1.2630344058299998	SG003	S2
15	81451916	81601393	ENSG00000172349.12	49	150	199	-1.6141088463799995	SG006	S29
19	49375649	49379314	ENSG00000087074.7	774	1002	1776	-0.372477037051	SG152	S68
1	111415775	111442550	ENSG00000143119.8	340	463	803	-0.445477447123	SG021	S14
X	49126306	49157929	ENSG00000049769.8	27	5	32	2.43295940728	SG046	S57
17	16345343	16395467	ENSG00000181350.7	17	53	70	-1.64045761331	SG043	S85
21	47608055	47648738	ENSG00000160285.10	441	551	992	-0.321273663014	SG151	S65
4	9772777	10056560	ENSG00000109667.7	26	5	31	2.37851162325	SG151	S64
12	54673977	54680872	ENSG00000135486.13	23	54	77	-1.23132554611	SG046	S57
8	146015151	146017972	ENSG00000161016.11	98	32	130	1.61470984412	SG041	S58
14	105952654	105955284	ENSG00000213145.5	264	431	695	-0.707149939731	SG031	S23
10	73724123	73773322	ENSG00000122863.5	30	8	38	1.90689059561	SG149	S90
X	76760356	77041702	ENSG00000085224.16	40	3	43	3.73696559417	SG007	S6
14	93403259	93582665	ENSG00000100605.12	317	415	732	-0.388628496095	SG152	S68
17	48623667	48633213	ENSG00000006282.15	42	169	211	-2.0085620135	SG042	S84
19	45853095	45874176	ENSG00000104884.10	87	146	233	-0.7468810630310001	SG042	S60
17	76419778	76573476	ENSG00000187775.12	26	113	139	-2.1197392442700003	SG148	S94
12	133264192	133294706	ENSG00000176894.5	128	76	204	0.752072486556	SG151	S65
X	152082986	152142024	ENSG00000147394.14	13	0	13	inf	SG022	S12
16	1494935	1525581	ENSG00000103249.13	94	147	241	-0.6450834931589999	SG045	S56
14	25278862	25519503	ENSG00000168952.11	13	1	14	3.70043971814	SG152	S70
1	144593363	144621656	ENSG00000225241.3	1	14	15	-3.80735492206	SG042	S84
3	53258723	53290047	ENSG00000163931.11	1184	1023	2207	0.210862935884	SG038	S53
X	53559057	53713673	ENSG00000086758.11	63	6	69	3.39231742278	SG022	S35
1	227177566	227506175	ENSG00000143776.14	116	2	118	5.85798099513	SG030	S21
20	43514317	43537173	ENSG00000166913.8	271	183	454	0.56644920307	SG023	S16
2	242673994	242708226	ENSG00000180902.12	268	169	437	0.665209754176	SG046	S80
X	119561682	119603220	ENSG00000005893.11	9	88	97	-3.2895066171900003	SG022	S35
19	49375649	49379314	ENSG00000087074.7	1887	2205	4092	-0.224684232844	SG042	S60
19	896503	913240	ENSG00000198858.5	50	104	154	-1.05658352837	SG152	S68
5	1568637	1594735	ENSG00000185986.10	67	18	85	1.89616418902	SG155	S42
17	48939584	48944856	ENSG00000141232.4	17	2	19	3.08746284125	SG149	S89
10	14560556	14816896	ENSG00000065809.9	169	81	250	1.0610294334	SG152	S70
2	190306159	190340291	ENSG00000115368.5	181	251	432	-0.471697666868	SG151	S65
7	134868590	134896316	ENSG00000105875.9	870	677	1547	0.361859567161	SG043	S62
22	17517460	17541715	ENSG00000237438.2	153	81	234	0.917537839808	SG023	S39
4	42112955	42154895	ENSG00000188848.11	83	39	122	1.08963721248	SG039	S74
3	98239976	98312567	ENSG00000080819.2	873	1052	1925	-0.269081145663	SG007	S5
14	35870717	35873952	ENSG00000100906.6	480	648	1128	-0.432959407276	SG150	S69
5	179233388	179264265	ENSG00000161011.15	913	1059	1972	-0.214015824008	SG043	S61
5	33424131	33440725	ENSG00000249572.1	14	1	15	3.80735492206	SG038	S52
22	24129150	24176689	ENSG00000099956.13	335	257	592	0.382392736151	SG148	S71
6	1624041	2245926	ENSG00000112699.6	23	54	77	-1.23132554611	SG001	S26
10	101635334	101769676	ENSG00000107554.11	17	2	19	3.08746284125	SG151	S65
5	150409506	150473138	ENSG00000145901.10	498	620	1118	-0.316122473206	SG045	S56
18	9708162	9862548	ENSG00000168461.8	19	92	111	-2.27563444261	SG031	S46
17	79476997	79490873	ENSG00000184009.5	911	1140	2051	-0.32351086525	SG031	S23
19	7753644	7767032	ENSG00000104921.10	1817	3110	4927	-0.775356160784	SG044	S63
6	7881656	7911047	ENSG00000239264.4	1811	2206	4017	-0.284646244641	SG006	S4
22	43547520	43559248	ENSG00000100300.13	149	75	224	0.990349829966	SG149	S90
5	66478103	66492627	ENSG00000134061.4	113	68	181	0.7327161211650001	SG001	S1
6	42931619	42946958	ENSG00000124587.9	84	141	225	-0.74723392962	SG038	S76
X	15337573	15353676	ENSG00000165195.9	29	0	29	inf	SG022	S11
18	10670238	11148587	ENSG00000154864.7	115	25	140	2.20163386117	SG150	S92
3	195384933	195456422	ENSG00000242086.4	47	16	63	1.55458885168	SG006	S28
1	169659808	169680839	ENSG00000188404.4	46	104	150	-1.17687776208	SG007	S5
7	32524951	32534895	ENSG00000106355.5	96	48	144	1.0	SG039	S75
19	48551100	48614074	ENSG00000105499.9	8	35	43	-2.12928301694	SG043	S85
17	5112256	5138155	ENSG00000161929.10	221	383	604	-0.793298022534	SG040	S50
3	141594966	141645356	ENSG00000069849.6	69	32	101	1.10852445678	SG002	S72
9	134452157	134615461	ENSG00000107263.14	506	345	851	0.552541023029	SG043	S85
13	43597339	43683045	ENSG00000120675.4	53	136	189	-1.35954238669	SG003	S3
2	219081817	219119079	ENSG00000163466.11	54	119	173	-1.13993026114	SG022	S11
13	96453834	96705736	ENSG00000102595.14	4	30	34	-2.90689059561	SG037	S78
8	28107580	28196556	ENSG00000253690.1	39	167	206	-2.09830207361	SG006	S4
6	89319985	89673348	ENSG00000111880.11	62	125	187	-1.0115879742799998	SG148	S71
3	197398264	197476598	ENSG00000145016.9	214	149	363	0.522298465939	SG021	S38
19	7753644	7767032	ENSG00000104921.10	832	1199	2031	-0.527176225273	SG027	S22
17	76142434	76162258	ENSG00000187997.7	85	35	120	1.28010791919	SG039	S51
1	183524698	183560011	ENSG00000116701.10	102	164	266	-0.685126662647	SG151	S64
11	5684425	5959849	ENSG00000132256.14	170	245	415	-0.527247002865	SG003	S2
X	39909068	40036582	ENSG00000183337.12	22	2	24	3.45943161864	SG148	S94
3	127407909	127542051	ENSG00000074416.9	67	33	100	1.0216950711	SG046	S81
20	300957	328868	ENSG00000225377.1	16	53	69	-1.7279204545599998	SG024	S37
11	48002113	48189670	ENSG00000149177.8	36	13	49	1.4694852833	SG043	S85
15	81451916	81601393	ENSG00000172349.12	143	77	220	0.893084796083	SG007	S5
7	134777115	134855547	ENSG00000122783.12	434	304	738	0.513623719001	SG041	S82
17	39777845	39943183	ENSG00000173801.12	37	12	49	1.62449086491	SG024	S36
6	18224099	18265054	ENSG00000124795.10	242	328	570	-0.4386887673430001	SG037	S77
19	17186591	17325346	ENSG00000099331.9	562	713	1275	-0.343331946223	SG069	S47
X	67867508	67945684	ENSG00000130052.9	0	11	11	-inf	SG031	S95
20	37049235	37063996	ENSG00000196756.7	256	118	374	1.1173569506399998	SG041	S59
14	96152754	96158980	ENSG00000213231.8	32	1	33	5.0	SG022	S11
2	191208196	191236391	ENSG00000151689.8	23	61	84	-1.40717538151	SG040	S73
10	11784365	11806069	ENSG00000134463.10	9	33	42	-1.87446911792	SG039	S75
13	96453834	96705736	ENSG00000102595.14	7	40	47	-2.51457317283	SG044	S87
16	70147529	70195203	ENSG00000090857.9	96	203	299	-1.08037341646	SG044	S63
4	113195698	113207059	ENSG00000145365.10	230	160	390	0.5235619560570001	SG150	S69
3	183205319	183273477	ENSG00000172578.7	31	76	107	-1.29373120306	SG040	S49
2	33661391	33789817	ENSG00000152689.13	140	241	381	-0.783606319285	SG021	S15
17	18174742	18218321	ENSG00000177302.10	24	56	80	-1.22239242134	SG155	S42
14	106320349	106322323	ENSG00000211899.3	4534	5197	9731	-0.196894667927	SG022	S11
14	24899141	24910540	ENSG00000100441.5	467	370	837	0.335897279193	SG003	S2
20	61584052	61599949	ENSG00000101194.13	834	682	1516	0.29027564442	SG045	S56
14	59927081	59951148	ENSG00000126790.7	97	25	122	1.95605665241	SG030	S43
22	22516592	22517074	ENSG00000211639.2	28	1	29	4.80735492206	SG041	S82
16	84599200	84651683	ENSG00000103187.6	1988	2311	4299	-0.217199502905	SG038	S52
15	25277195	25281637	ENSG00000257151.1	14	0	14	inf	SG155	S19
3	39371197	39375171	ENSG00000179934.5	15	1	16	3.90689059561	SG040	S49
20	47835884	47860614	ENSG00000124228.10	155	77	232	1.00933786458	SG007	S30
12	131438452	131626014	ENSG00000111452.8	9	36	45	-2.0	SG024	S13
15	31196055	31235311	ENSG00000198690.5	198	127	325	0.640671933307	SG044	S86
15	40780240	40850183	ENSG00000259536.1	173	77	250	1.16784168694	SG150	S69
12	104359582	104382652	ENSG00000139372.10	49	20	69	1.29278174923	SG039	S74
9	4676600	4679502	ENSG00000273061.1	17	1	18	4.08746284125	SG030	S21
1	160965001	160991138	ENSG00000158769.13	423	323	746	0.389123498426	SG151	S65
19	16222439	16244837	ENSG00000167461.7	530	424	954	0.321928094887	SG151	S65
2	234263153	234380750	ENSG00000077044.5	55	114	169	-1.05153030064	SG007	S5
8	27168999	27316903	ENSG00000120899.13	833	1180	2013	-0.502398458884	SG031	S23
14	106733144	106733639	ENSG00000211950.2	23	1	24	4.52356195606	SG150	S92
6	24667263	24705088	ENSG00000112304.6	25	54	79	-1.11103131239	SG022	S35
20	23608534	23619110	ENSG00000101439.4	45	110	155	-1.28950661719	SG044	S87
19	14844559	14889353	ENSG00000127507.13	6	35	41	-2.54432051622	SG149	S89
22	45704849	45737836	ENSG00000100376.7	262	76	338	1.7854954880900002	SG043	S62
9	113006091	113018920	ENSG00000136810.8	511	380	891	0.427323872607	SG040	S49
20	60962172	60963576	ENSG00000171858.13	45	14	59	1.6844981742700005	SG046	S81
1	22351681	22357716	ENSG00000218510.3	59	107	166	-0.858823937039	SG069	S24
X	106307650	106362057	ENSG00000089682.12	16	1	17	4.0	SG152	S70
X	102930424	102941746	ENSG00000123562.12	38	9	47	2.078002512	SG046	S80
8	145159402	145162514	ENSG00000179632.5	118	186	304	-0.656515761746	SG038	S76
11	2316875	2324279	ENSG00000110665.7	49	0	49	inf	SG042	S60
1	167599330	167675486	ENSG00000198771.6	196	113	309	0.7945308817	SG007	S6
20	57608200	57617964	ENSG00000101166.11	81	145	226	-0.84005908713	SG150	S93
19	5691888	5720583	ENSG00000196365.7	112	175	287	-0.643856189775	SG025	S10
X	40507558	40595110	ENSG00000180182.6	45	12	57	1.90689059561	SG007	S5
15	63900817	64126141	ENSG00000103657.9	56	114	170	-1.0255350921100002	SG069	S24
11	832884	839720	ENSG00000177697.13	106	36	142	1.55799545312	SG024	S37
19	18683418	18718551	ENSG00000006016.6	412	542	954	-0.395648514171	SG011	S8
1	28199055	28213196	ENSG00000130775.11	88	44	132	1.0	SG003	S2
2	98330023	98356325	ENSG00000115085.9	40	15	55	1.41503749928	SG150	S69
13	33677272	33924767	ENSG00000133121.16	68	23	91	1.56390088519	SG040	S73
16	15068448	15233196	ENSG00000179889.14	302	216	518	0.483517237162	SG003	S2
17	7529552	7531194	ENSG00000141504.7	49	20	69	1.29278174923	SG003	S2
1	169631245	169823221	ENSG00000000460.12	417	216	633	0.949016071281	SG151	S65
22	23222886	23223576	ENSG00000211673.2	4	102	106	-4.67242534197	SG040	S49
6	113944737	113971276	ENSG00000230943.1	15	1	16	3.90689059561	SG043	S62
2	190306159	190340291	ENSG00000115368.5	270	169	439	0.6759361607690001	SG150	S69
2	89512908	89513413	ENSG00000244575.1	71	2	73	5.1497471195	SG027	S22
8	22479028	22526661	ENSG00000147439.7	20	50	70	-1.3219280948899998	SG039	S74
12	120648323	120703574	ENSG00000089159.11	6	31	37	-2.36923380967	SG155	S42
7	66093868	66262493	ENSG00000243335.4	67	31	98	1.11189288007	SG043	S62
20	34213953	34252878	ENSG00000214078.7	443	225	668	0.977381697338	SG041	S59
1	26644448	26647014	ENSG00000169442.4	837	687	1524	0.284917523732	SG037	S78
X	77166194	77305892	ENSG00000165240.13	5	28	33	-2.48542682717	SG038	S53
16	70190243	70207224	ENSG00000247228.2	156	89	245	0.809668787896	SG155	S42
7	92759368	92777682	ENSG00000177409.7	159	235	394	-0.563633991281	SG030	S43
18	23596578	23671181	ENSG00000141380.9	88	44	132	1.0	SG045	S56
18	657604	673578	ENSG00000176890.11	314	233	547	0.430434604237	SG039	S75
22	22569184	22569660	ENSG00000211642.2	59	1	60	5.88264304936	SG040	S73
3	122399465	122449687	ENSG00000173193.9	826	1120	1946	-0.439285045526	SG041	S58
17	34400226	34417331	ENSG00000224298.2	315	220	535	0.517848304863	SG041	S82
1	160709037	160724611	ENSG00000026751.12	603	454	1057	0.409465704609	SG024	S13
14	59927081	59951148	ENSG00000126790.7	31	100	131	-1.6896598793900002	SG046	S81
10	34398488	35104253	ENSG00000148498.11	38	12	50	1.6629650127200002	SG006	S29
5	304291	438406	ENSG00000063438.12	283	429	712	-0.600175594668	SG021	S14
2	127805603	127864931	ENSG00000136717.10	107	162	269	-0.598383016483	SG003	S3
16	84511681	84587639	ENSG00000140950.11	81	40	121	1.017921908	SG002	S72
13	48963707	49018840	ENSG00000139679.11	15	1	16	3.90689059561	SG043	S85
15	50647606	50659636	ENSG00000244879.3	22	73	95	-1.7303929402400002	SG038	S76
9	116018115	116035718	ENSG00000176386.4	39	13	52	1.58496250072	SG021	S15
3	183853052	184402546	ENSG00000145191.7	491	377	868	0.381158501046	SG040	S49
17	63524681	63557765	ENSG00000168646.8	0	15	15	-inf	SG150	S69
15	34671272	34880704	ENSG00000175265.13	149	47	196	1.66457966878	SG040	S73
5	96149731	96271097	ENSG00000247121.2	523	156	679	1.74526491738	SG042	S83
7	129932974	129964020	ENSG00000128510.6	0	11	11	-inf	SG024	S36
3	191046866	191116459	ENSG00000152492.9	554	450	1004	0.299960974832	SG003	S27
14	65381079	65411309	ENSG00000258289.3	107	52	159	1.04102726826	SG024	S36
17	79993012	79995608	ENSG00000169738.3	52	100	152	-0.943416471634	SG152	S70
12	92378756	92535489	ENSG00000257242.2	59	139	198	-1.23629802336	SG044	S63
10	112631565	112658487	ENSG00000150593.11	44	108	152	-1.29545588353	SG006	S28
17	46952222	46986345	ENSG00000248278.1	79	40	119	0.98185265329	SG006	S28
22	37600278	37608362	ENSG00000183473.5	98	161	259	-0.7162070339990001	SG043	S62
19	18169805	18209754	ENSG00000096996.11	133	194	327	-0.544630406686	SG006	S4
X	46433219	46457843	ENSG00000147119.3	20	3	23	2.73696559417	SG046	S57
17	33570055	33600674	ENSG00000166750.5	262	4	266	6.03342300154	SG011	S32
1	40157854	40229586	ENSG00000084072.12	38	95	133	-1.3219280948899998	SG001	S1
11	2465914	2870339	ENSG00000053918.11	1	29	30	-4.85798099513	SG002	S72
X	13396854	13397459	ENSG00000197582.5	46	0	46	inf	SG148	S71
19	45853095	45874176	ENSG00000104884.10	48	89	137	-0.890770930245	SG030	S20
4	159690290	159829201	ENSG00000052795.8	19	2	21	3.2479275134400005	SG001	S26
20	30865467	30922814	ENSG00000101350.6	55	25	80	1.13750352375	SG152	S68
1	160765864	160798051	ENSG00000122224.13	101	152	253	-0.5897160306920001	SG152	S68
1	167599330	167675486	ENSG00000198771.6	137	197	334	-0.524019736496	SG152	S91
2	61404553	61418338	ENSG00000173209.18	80	138	218	-0.786596361891	SG023	S39
2	9983483	10074545	ENSG00000115750.12	29	62	91	-1.09621531526	SG003	S27
1	169659808	169680839	ENSG00000188404.4	648	272	920	1.25238716163	SG030	S21
11	287305	288987	ENSG00000255026.1	12	42	54	-1.80735492206	SG151	S65
19	1026298	1039068	ENSG00000064666.10	279	401	680	-0.523337114626	SG025	S10
20	37049235	37063996	ENSG00000196756.7	76	190	266	-1.3219280948899998	SG022	S12
1	6051526	6161253	ENSG00000069424.10	483	678	1161	-0.489262084301	SG043	S85
10	105148823	105156223	ENSG00000173915.8	39	99	138	-1.34395440122	SG042	S84
18	47013709	47018248	ENSG00000265496.2	77	126	203	-0.710493382805	SG002	S72
1	161676762	161684142	ENSG00000132185.12	129	235	364	-0.8652896911419999	SG148	S71
X	13395307	13421138	ENSG00000226434.1	0	139	139	-inf	SG003	S3
10	13319796	13344412	ENSG00000107537.9	5	23	28	-2.20163386117	SG046	S80
4	492989	533318	ENSG00000174227.11	242	323	565	-0.416527117419	SG038	S76
16	29674300	29682187	ENSG00000197471.7	55	16	71	1.78135971352	SG045	S56
22	42905974	42915808	ENSG00000189306.6	67	131	198	-0.96733381108	SG042	S60
21	45138975	45182188	ENSG00000160209.14	150	217	367	-0.532732541949	SG030	S20
2	120124497	120130126	ENSG00000155368.12	20	54	74	-1.4329594072799998	SG043	S62
17	33570055	33600674	ENSG00000166750.5	9	278	287	-4.94901607128	SG003	S2
13	43597339	43683045	ENSG00000120675.4	94	29	123	1.69660785655	SG011	S9
16	70286198	70323446	ENSG00000090861.11	252	183	435	0.461580085216	SG152	S70
3	121350246	121379774	ENSG00000180353.6	811	597	1408	0.441970982952	SG001	S26
19	3141574	3155173	ENSG00000267551.3	50	22	72	1.18442457114	SG151	S65
17	21279509	21323179	ENSG00000184185.5	45	6	51	2.90689059561	SG149	S90
7	1036622	1177896	ENSG00000146540.10	612	466	1078	0.393201698038	SG069	S48
12	120875893	120878545	ENSG00000111775.2	3	22	25	-2.87446911792	SG041	S58
X	132434131	132549518	ENSG00000076716.7	2	21	23	-3.39231742278	SG022	S11
17	33570055	33600674	ENSG00000166750.5	76	6	82	3.66296501272	SG026	S17
19	39833036	39876350	ENSG00000179134.10	100	57	157	0.8109661756100001	SG151	S88
19	5158506	5340814	ENSG00000105426.10	13	43	56	-1.72582503656	SG027	S45
10	105148823	105156223	ENSG00000173915.8	36	3	39	3.58496250072	SG038	S52
20	29611857	29634010	ENSG00000149531.10	24	4	28	2.58496250072	SG151	S64
21	15399742	15516789	ENSG00000224905.2	23	64	87	-1.47643804394	SG152	S68
3	174952651	174988885	ENSG00000226779.1	181	72	253	1.32992088564	SG046	S57
X	9431335	9687780	ENSG00000101849.11	53	6	59	3.14295795384	SG046	S80
10	101635334	101769676	ENSG00000107554.11	127	79	206	0.6849039385950001	SG041	S58
20	34894258	35157040	ENSG00000080845.13	18	1	19	4.16992500144	SG044	S87
19	35485688	35517375	ENSG00000089351.10	211	127	338	0.732414501935	SG022	S11
6	12290596	12297427	ENSG00000078401.6	40	14	54	1.5145731728299998	SG027	S44
6	6144318	6321246	ENSG00000124491.11	11	37	48	-1.75002174699	SG039	S51
X	134382867	134478012	ENSG00000186376.10	17	57	74	-1.7454271729099995	SG007	S6
1	19403234	19536770	ENSG00000127481.10	259	359	618	-0.471031746136	SG022	S11
19	35485688	35517375	ENSG00000089351.10	126	201	327	-0.673771767679	SG021	S38
11	307631	309395	ENSG00000185201.12	441	252	693	0.807354922058	SG043	S62
14	24612574	24616444	ENSG00000100911.9	493	624	1117	-0.339958382484	SG003	S3
10	3183930	3210164	ENSG00000237399.3	116	174	290	-0.584962500721	SG148	S94
2	71291474	71306935	ENSG00000124357.8	103	207	310	-1.00698643032	SG007	S5
16	103010	107669	ENSG00000161981.6	45	108	153	-1.2630344058299998	SG006	S4
3	48507116	48509044	ENSG00000213689.5	114	172	286	-0.593374740537	SG150	S93
7	6061881	6098861	ENSG00000086232.8	38	93	131	-1.29123129766	SG043	S62
17	38060848	38074903	ENSG00000073605.14	114	215	329	-0.915302835425	SG039	S75
19	47759237	47775210	ENSG00000105321.8	172	111	283	0.6318488883519999	SG041	S59
8	110374706	110542559	ENSG00000205038.7	39	12	51	1.7004397181400002	SG002	S7
14	107113741	107114274	ENSG00000223648.2	13	111	124	-3.09397614821	SG023	S96
2	54683422	54896812	ENSG00000115306.11	235	153	388	0.6191291038719999	SG046	S80
2	39663778	39873530	ENSG00000231312.2	2	17	19	-3.08746284125	SG026	S18
10	124608594	124639157	ENSG00000213185.2	31	4	35	2.9541963103900004	SG045	S56
17	38060848	38074903	ENSG00000073605.14	99	204	303	-1.04306872189	SG149	S66
8	48685669	48872743	ENSG00000253729.3	98	50	148	0.97085365434	SG003	S3
20	62681189	62703700	ENSG00000171703.12	35	8	43	2.12928301694	SG069	S47
7	56169262	56174269	ENSG00000106153.12	109	57	166	0.935294310612	SG031	S95
22	23247030	23247205	ENSG00000211678.2	350	6	356	5.86624861111	SG007	S30
13	21877654	21922860	ENSG00000224429.3	31	9	40	1.7842713089400002	SG149	S89
16	19714902	19729016	ENSG00000103550.9	35	6	41	2.54432051622	SG040	S49
14	106926188	106926724	ENSG00000232216.1	12	0	12	inf	SG148	S71
21	45770046	45862964	ENSG00000142185.12	43	9	52	2.25633975326	SG150	S93
20	62152077	62153559	ENSG00000125534.5	95	169	264	-0.831023827951	SG042	S60
1	40026488	40042462	ENSG00000090621.9	414	297	711	0.479167836699	SG041	S58
9	140083099	140084822	ENSG00000176101.7	17	2	19	3.08746284125	SG002	S7
20	61584052	61599949	ENSG00000101194.13	829	658	1487	0.333284517761	SG046	S57
8	2523591	2585991	ENSG00000254319.1	0	14	14	-inf	SG152	S91
6	170110332	170124151	ENSG00000130024.10	15	1	16	3.90689059561	SG042	S83
18	9334765	9402418	ENSG00000128791.7	103	57	160	0.853610513018	SG155	S19
19	36195429	36207940	ENSG00000011590.9	371	266	637	0.47999294112	SG040	S49
2	6968645	6980595	ENSG00000225964.1	7	32	39	-2.1926450779400004	SG025	S33
12	54747576	54860769	ENSG00000258086.1	0	11	11	-inf	SG148	S67
7	112740718	112786385	ENSG00000225457.1	10	33	43	-1.72246602447	SG044	S86
X	112017731	112084043	ENSG00000126016.9	28	0	28	inf	SG021	S38
11	121322912	121504402	ENSG00000137642.8	494	737	1231	-0.5771535775100001	SG148	S71
22	23247030	23247205	ENSG00000211678.2	0	45	45	-inf	SG151	S88
X	47420516	47431302	ENSG00000078061.8	38	87	125	-1.19501598241	SG044	S86
7	150130742	150145228	ENSG00000242258.1	344	445	789	-0.371396771152	SG037	S78
5	96211643	96255420	ENSG00000164308.12	401	66	467	2.6030643071	SG006	S29
16	18792617	18801705	ENSG00000134419.11	100	160	260	-0.678071905113	SG149	S89
14	106733144	106733639	ENSG00000211950.2	0	14	14	-inf	SG046	S81
8	56792372	56923940	ENSG00000254087.3	227	104	331	1.12610876915	SG044	S63
22	22707289	22707781	ENSG00000211647.1	25	6	31	2.05889368905	SG024	S36
7	2945775	3083579	ENSG00000198286.5	119	208	327	-0.805621954833	SG041	S58
5	10654332	10657928	ENSG00000272016.1	280	202	482	0.471071534193	SG038	S76
11	8703958	8736306	ENSG00000166441.8	32	153	185	-2.25738784269	SG040	S73
19	46171502	46186982	ENSG00000010310.4	62	113	175	-0.8659826520280001	SG002	S72
19	28926295	29218684	ENSG00000267243.1	23	1	24	4.52356195606	SG026	S17
19	47104493	47114050	ENSG00000160014.12	279	200	479	0.480265122054	SG148	S71
14	100800125	100843142	ENSG00000140105.13	154	222	376	-0.527629325655	SG002	S7
4	10488019	10686489	ENSG00000109684.10	12	37	49	-1.62449086491	SG007	S30
5	304291	438406	ENSG00000063438.12	289	443	732	-0.616237206054	SG038	S52
11	1874200	1913497	ENSG00000130592.9	875	1036	1911	-0.243669080967	SG046	S80
11	62619460	62623386	ENSG00000255717.2	77	146	223	-0.923038018185	SG024	S36
17	36342584	36421841	ENSG00000174093.6	2	18	20	-3.16992500144	SG001	S26
X	46464753	46618490	ENSG00000065923.5	53	108	161	-1.0269670476	SG040	S50
9	136197552	136203235	ENSG00000148296.5	104	172	276	-0.7258250365610001	SG043	S85
X	23801290	23804343	ENSG00000130066.12	27	74	101	-1.45456586347	SG021	S38
2	231033634	231090444	ENSG00000135899.12	288	191	479	0.592496173407	SG041	S82
4	1205236	1242925	ENSG00000159692.11	97	155	252	-0.6762115630869999	SG031	S23
4	75858305	75975325	ENSG00000169116.7	59	112	171	-0.924711872696	SG001	S1
3	57994127	58157982	ENSG00000136068.10	20	60	80	-1.58496250072	SG023	S39
17	12692856	12894960	ENSG00000006740.12	1	19	20	-4.2479275134400005	SG043	S62
13	74260226	74708394	ENSG00000118922.12	33	8	41	2.04439411936	SG002	S7
17	76494911	76499138	ENSG00000268470.1	18	0	18	inf	SG027	S45
22	23247030	23247205	ENSG00000211678.2	47	0	47	inf	SG043	S62
X	153576892	153603006	ENSG00000196924.10	380	102	482	1.89743026636	SG148	S67
11	64002010	64006259	ENSG00000173511.5	243	156	399	0.639410284744	SG046	S57
7	5229819	5273457	ENSG00000157954.10	98	49	147	1.0	SG031	S46
11	18415935	18429972	ENSG00000134333.9	677	402	1079	0.751960332396	SG001	S26
19	49990811	49995565	ENSG00000142541.12	56	110	166	-0.974004791467	SG022	S11
15	23282281	23378228	ENSG00000140181.10	2	38	40	-4.2479275134400005	SG006	S28
20	58662895	59102516	ENSG00000228340.1	20	1	21	4.3219280948900005	SG021	S14
X	129198849	129244691	ENSG00000102034.12	14	131	145	-3.22606807948	SG022	S35
6	3722848	3739395	ENSG00000168994.9	44	81	125	-0.880418384247	SG043	S61
1	3728645	3773778	ENSG00000116198.8	160	91	251	0.814133454689	SG151	S64
18	12991361	13125051	ENSG00000101639.14	150	98	248	0.6141088463809999	SG003	S3
21	35275757	35288284	ENSG00000241837.2	598	757	1355	-0.340147815788	SG011	S8
X	13752832	13787480	ENSG00000046651.10	5	33	38	-2.72246602447	SG152	S91
17	27582854	27621136	ENSG00000108256.4	42	16	58	1.39231742278	SG042	S60
X	47305278	47342345	ENSG00000147124.8	30	3	33	3.32192809489	SG022	S12
8	146015151	146017972	ENSG00000161016.11	2231	1891	4122	0.238541150294	SG039	S74
16	89557325	89624176	ENSG00000197912.9	246	337	583	-0.454090275843	SG043	S61
3	119298498	119308792	ENSG00000144843.7	174	89	263	0.967210064882	SG149	S66
12	7260648	7275097	ENSG00000205885.3	69	25	94	1.464668267	SG022	S12
14	107078373	107078869	ENSG00000211968.2	160	11	171	3.86249647625	SG030	S21
4	10075963	10118573	ENSG00000071127.12	392	511	903	-0.382469636822	SG030	S21
15	101590937	101626271	ENSG00000259755.1	144	92	236	0.646363045385	SG030	S20
2	106361354	106510730	ENSG00000071051.9	57	21	78	1.44057259139	SG152	S68
11	76571911	76737841	ENSG00000078124.7	42	13	55	1.6918777046399998	SG148	S67
17	5112256	5138155	ENSG00000161929.10	384	589	973	-0.6171613231090001	SG152	S91
10	3183930	3210164	ENSG00000237399.3	97	204	301	-1.07251249978	SG001	S25
20	57393974	57425958	ENSG00000235590.3	0	11	11	-inf	SG039	S51
1	3728645	3773778	ENSG00000116198.8	45	94	139	-1.06273575535	SG024	S36
5	175792471	175828866	ENSG00000175414.6	244	382	626	-0.646691490473	SG046	S57
2	10927407	10978103	ENSG00000143870.8	889	1082	1971	-0.283445174997	SG011	S8
X	134654600	134716435	ENSG00000165359.10	53	12	65	2.14295795384	SG069	S48
17	34136459	34191619	ENSG00000172660.7	47	12	59	1.96962635096	SG011	S32
22	42905974	42915808	ENSG00000189306.6	67	139	206	-1.0528518822700002	SG023	S16
3	127407909	127542051	ENSG00000074416.9	229	364	593	-0.668590852102	SG152	S68
14	74318547	74353319	ENSG00000140043.7	16	51	67	-1.67242534197	SG043	S62
11	289138	296107	ENSG00000142102.11	315	150	465	1.07038932789	SG025	S10
10	45869661	45941561	ENSG00000012779.6	83	159	242	-0.937843523937	SG011	S32
13	27825446	27830828	ENSG00000122026.6	79	40	119	0.98185265329	SG003	S27
6	130686879	130764208	ENSG00000164484.7	15	1	16	3.90689059561	SG003	S2
3	98239976	98312567	ENSG00000080819.2	516	399	915	0.3709823192010001	SG046	S57
13	43460524	43566385	ENSG00000133106.10	51	159	210	-1.64045761331	SG002	S72
2	65454887	65498387	ENSG00000138071.9	183	268	451	-0.550389352174	SG155	S42
X	131337053	131353471	ENSG00000123728.5	3	49	52	-4.02974734339	SG022	S35
1	150702672	150738433	ENSG00000163131.6	67	132	199	-0.978304928901	SG031	S46
14	24834879	24848810	ENSG00000100968.9	79	151	230	-0.934623991148	SG042	S84
19	16607122	16632163	ENSG00000105072.4	71	117	188	-0.720617600079	SG046	S57
17	289769	295730	ENSG00000183688.4	96	53	149	0.857042046158	SG069	S24
9	6532464	6645650	ENSG00000178445.8	26	66	92	-1.34395440122	SG024	S13
17	42396993	42402238	ENSG00000013306.11	124	49	173	1.33948646627	SG022	S12
14	106733144	106733639	ENSG00000211950.2	0	279	279	-inf	SG001	S26
3	194308402	194354418	ENSG00000145014.13	22	54	76	-1.29545588353	SG024	S36
21	47656743	47706211	ENSG00000160294.6	199	272	471	-0.450838220707	SG043	S85
22	42905974	42915808	ENSG00000189306.6	119	50	169	1.25096157353	SG043	S62
X	46433219	46457843	ENSG00000147119.3	14	0	14	inf	SG152	S70
7	1036622	1177896	ENSG00000146540.10	498	361	859	0.464146905181	SG003	S27
14	107113741	107114274	ENSG00000223648.2	11	63	74	-2.51784830486	SG007	S6
1	155867599	155881195	ENSG00000143622.6	8	33	41	-2.04439411936	SG039	S51
2	153191751	153506348	ENSG00000157827.15	14	73	87	-2.38246963682	SG043	S61
21	30449792	30548210	ENSG00000156265.11	3	27	30	-3.16992500144	SG043	S61
12	114254543	114404176	ENSG00000122965.6	149	97	246	0.619255678275	SG001	S1
21	36160098	37376965	ENSG00000159216.14	0	11	11	-inf	SG042	S84
5	180467225	180488523	ENSG00000165810.12	19	1	20	4.2479275134400005	SG044	S63
1	45100910	45140227	ENSG00000126106.9	39	77	116	-0.981384321833	SG152	S70
10	3183930	3210164	ENSG00000237399.3	87	209	296	-1.26441563623	SG001	S26
22	47080308	47134158	ENSG00000100422.9	218	146	364	0.578359765897	SG039	S74
7	75162621	75368280	ENSG00000127946.12	41	14	55	1.5501970825600002	SG039	S51
19	9523272	9546254	ENSG00000174652.13	128	55	183	1.21864028648	SG044	S86
17	76164639	76169608	ENSG00000108639.3	977	773	1750	0.337890148044	SG042	S60
1	213025450	213031430	ENSG00000198468.3	42	9	51	2.22239242134	SG003	S2
19	18682540	18688360	ENSG00000221983.3	638	471	1109	0.437829364152	SG006	S28
14	96116838	96146170	ENSG00000187621.10	254	63	317	2.0114047632700003	SG024	S13
14	24608177	24610797	ENSG00000100908.9	8	29	37	-1.85798099513	SG006	S29
16	8882680	8941961	ENSG00000140650.7	13	45	58	-1.79141337819	SG043	S62
4	10488019	10686489	ENSG00000109684.10	19	83	102	-2.1271119179	SG025	S34
20	60883011	60942368	ENSG00000130702.9	52	21	73	1.30812229536	SG041	S59
15	45021186	45060027	ENSG00000185880.8	96	151	247	-0.653442238604	SG045	S79
15	91426925	91439006	ENSG00000182511.7	6	29	35	-2.27301849441	SG155	S42
11	64084216	64085556	ENSG00000173113.2	8	59	67	-2.88264304936	SG023	S39
11	832884	839720	ENSG00000177697.13	135	46	181	1.55325364099	SG024	S36
1	169659808	169680839	ENSG00000188404.4	43	85	128	-0.983126181436	SG007	S6
12	6554033	6560855	ENSG00000139193.3	137	219	356	-0.676754976641	SG002	S72
17	5402747	5522744	ENSG00000091592.11	526	405	931	0.37714089152	SG155	S41
X	47431308	47479252	ENSG00000008056.8	193	4	197	5.59245703727	SG152	S68
6	117642380	117923691	ENSG00000047932.9	39	11	50	1.82597060022	SG025	S34
4	185286336	185303460	ENSG00000249096.2	38	91	129	-1.25986712676	SG039	S51
15	50647606	50659636	ENSG00000244879.3	45	108	153	-1.2630344058299998	SG046	S57
18	47014854	47018906	ENSG00000265681.2	114	206	320	-0.853610513018	SG022	S12
4	185261909	185275130	ENSG00000180712.3	42	93	135	-1.14684138833	SG148	S67
6	36410667	36458920	ENSG00000112078.9	158	232	390	-0.55420024695	SG152	S68
22	31003071	31023265	ENSG00000185339.4	189	117	306	0.691877704638	SG045	S79
15	65950384	66084631	ENSG00000174485.10	75	37	112	1.01936532487	SG155	S42
5	95860971	96115299	ENSG00000153113.19	277	124	401	1.15954585566	SG031	S95
1	233086351	233119180	ENSG00000135778.7	37	9	46	2.03952836419	SG021	S38
22	23247030	23247205	ENSG00000211678.2	0	57	57	-inf	SG155	S19
6	111303218	111349466	ENSG00000197498.8	54	24	78	1.16992500144	SG024	S13
7	29638411	29724769	ENSG00000225264.3	11	0	11	inf	SG041	S58
20	5525085	5591672	ENSG00000125772.8	233	337	570	-0.532418636528	SG046	S57
22	36677327	36784063	ENSG00000100345.16	1129	1304	2433	-0.207898383458	SG002	S31
8	65713793	65730130	ENSG00000254006.1	61	26	87	1.23029761942	SG024	S37
2	173420101	173489823	ENSG00000152256.9	149	213	362	-0.515541099764	SG037	S54
14	106494135	106494597	ENSG00000211937.2	5	171	176	-5.09592442	SG044	S63
19	50433021	50437192	ENSG00000169136.4	131	526	657	-2.0054959877500003	SG024	S36
5	175810949	175815976	ENSG00000048162.15	287	158	445	0.8611261784990001	SG038	S76
14	106494135	106494597	ENSG00000211937.2	57	13	70	2.13245029602	SG148	S67
4	154387498	154557863	ENSG00000121210.11	251	178	429	0.495810122984	SG069	S47
8	143530791	143626370	ENSG00000181790.6	4	23	27	-2.52356195606	SG039	S51
1	213123862	213165379	ENSG00000143494.11	76	23	99	1.7243655573900003	SG044	S63
1	213025450	213031430	ENSG00000198468.3	34	8	42	2.08746284125	SG025	S10
21	47608055	47648738	ENSG00000160285.10	431	244	675	0.8208067215260001	SG025	S33
X	129003040	129091504	ENSG00000235189.1	55	26	81	1.08091999538	SG148	S71
6	25081548	25166793	ENSG00000168405.10	27	59	86	-1.1277555472	SG023	S96
X	19362011	19379823	ENSG00000131828.9	22	1	23	4.45943161864	SG007	S5
22	43547520	43559248	ENSG00000100300.13	78	175	253	-1.16580889297	SG022	S11
22	22550113	22550860	ENSG00000211640.3	228	352	580	-0.626541604473	SG025	S33
9	74729511	74872109	ENSG00000119125.12	1	16	17	-4.0	SG043	S61
1	179923873	180084015	ENSG00000135837.11	25	6	31	2.05889368905	SG151	S88
8	30241944	30429778	ENSG00000157110.11	34	10	44	1.7655347463599995	SG045	S56
14	95883831	95942173	ENSG00000176438.8	57	19	76	1.58496250072	SG025	S34
4	38773860	38784611	ENSG00000174123.6	166	272	438	-0.712423409903	SG003	S2
16	84211525	84220669	ENSG00000103168.12	233	122	355	0.933448807091	SG042	S83
5	149781200	149792492	ENSG00000019582.10	3096	3436	6532	-0.150324564994	SG037	S77
7	2719156	2815134	ENSG00000174945.9	128	213	341	-0.734709620226	SG041	S58
3	52558512	52569070	ENSG00000168268.6	100	58	158	0.785875194647	SG025	S33
1	23884409	23886285	ENSG00000117318.8	489	383	872	0.352490073027	SG042	S60
11	44087475	44105764	ENSG00000110455.9	59	151	210	-1.35576168996	SG046	S80
17	5267610	5274921	ENSG00000263220.1	22	51	73	-1.21299372333	SG024	S36
17	76183398	76203782	ENSG00000183077.11	2	17	19	-3.08746284125	SG040	S49
20	62605466	62611361	ENSG00000130590.9	405	651	1056	-0.684735635394	SG148	S71
7	130538479	130613408	ENSG00000233559.1	4	25	29	-2.64385618977	SG149	S89
X	68380694	68385636	ENSG00000181191.11	47	16	63	1.55458885168	SG069	S48
3	42055294	42267381	ENSG00000182606.10	82	132	214	-0.6868421147399999	SG151	S65
1	31205316	31230667	ENSG00000162511.7	955	686	1641	0.47729215675	SG042	S60
22	36622256	36636000	ENSG00000128335.9	113	190	303	-0.749676645916	SG045	S55
11	126173647	126215644	ENSG00000110063.4	117	185	302	-0.661016740933	SG044	S87
1	6051526	6161253	ENSG00000069424.10	557	728	1285	-0.386261122859	SG150	S92
2	85811531	85820535	ENSG00000168899.4	15	50	65	-1.73696559417	SG021	S15
X	153058971	153063960	ENSG00000180879.9	54	15	69	1.84799690655	SG022	S11
3	45596886	45727830	ENSG00000144791.5	220	350	570	-0.669851398308	SG041	S58
8	56792372	56923940	ENSG00000254087.3	261	139	400	0.908964923846	SG046	S57
20	37049235	37063996	ENSG00000196756.7	123	257	380	-1.06311004385	SG043	S85
22	29950797	29977326	ENSG00000184117.7	51	93	144	-0.866733469137	SG152	S91
3	127770484	127790526	ENSG00000058262.5	735	599	1334	0.295188246935	SG025	S10
11	43577986	43878160	ENSG00000149084.7	82	145	227	-0.822357085397	SG150	S69
1	24291294	24307417	ENSG00000188529.10	3	32	35	-3.41503749928	SG006	S4
14	55738027	55828636	ENSG00000178974.5	49	92	141	-0.908852111942	SG030	S43
7	134777115	134855547	ENSG00000122783.12	342	448	790	-0.389502407172	SG148	S94
19	50410082	50432957	ENSG00000213024.6	266	355	621	-0.416392778891	SG150	S92
17	3566196	3571976	ENSG00000213977.3	44	93	137	-1.07972719247	SG155	S42
17	37026112	37078023	ENSG00000002834.13	411	315	726	0.383786565294	SG022	S11
17	289769	295730	ENSG00000183688.4	163	65	228	1.3263603412	SG002	S31
20	32319463	32380075	ENSG00000131061.9	14	1	15	3.80735492206	SG046	S57
16	89557325	89624176	ENSG00000197912.9	237	314	551	-0.4058774999930001	SG042	S84
13	43460524	43566385	ENSG00000133106.10	149	40	189	1.89724042557	SG025	S10
11	125440180	125462473	ENSG00000254671.1	20	51	71	-1.35049724708	SG021	S38
17	37026112	37078023	ENSG00000002834.13	133	51	184	1.3828570935299995	SG011	S32
21	43218385	43299591	ENSG00000141956.9	152	297	449	-0.966391607357	SG031	S95
6	52362200	52441713	ENSG00000065308.4	36	105	141	-1.54432051622	SG023	S16
X	119384607	119392253	ENSG00000177485.6	27	1	28	4.75488750216	SG152	S91
14	92582466	92588261	ENSG00000183648.5	139	202	341	-0.539270410028	SG151	S64
14	107113741	107114274	ENSG00000223648.2	21	2	23	3.39231742278	SG027	S22
11	124932963	124958376	ENSG00000134955.7	100	152	252	-0.604071323669	SG038	S52
14	94843084	94857030	ENSG00000197249.8	22	2	24	3.45943161864	SG151	S64
3	107762145	107809872	ENSG00000196776.10	91	48	139	0.922832139478	SG069	S48
13	46700055	46786006	ENSG00000136167.9	2034	2322	4356	-0.191048293008	SG001	S1
4	113195698	113207059	ENSG00000145365.10	190	120	310	0.662965012722	SG150	S93
14	107178820	107179338	ENSG00000211974.2	115	1	116	6.84549005094	SG001	S26
1	160709037	160724611	ENSG00000026751.12	256	430	686	-0.748192849589	SG011	S8
X	133677367	133680741	ENSG00000223749.3	1	16	17	-4.0	SG031	S23
12	65107225	65153227	ENSG00000135677.6	65	27	92	1.26748031086	SG155	S19
1	181382238	181777219	ENSG00000198216.6	23	65	88	-1.49880585697	SG040	S50
X	71549366	71792953	ENSG00000147099.15	36	3	39	3.58496250072	SG022	S35
22	50686121	50700254	ENSG00000188130.9	242	156	398	0.633461018412	SG041	S82
1	147101453	147142618	ENSG00000162836.7	32	8	40	2.0	SG151	S64
19	17263398	17278752	ENSG00000268056.1	89	46	135	0.952171474909	SG042	S84
19	19496635	19619740	ENSG00000167491.13	236	166	402	0.507603618015	SG037	S78
19	50922195	50934570	ENSG00000269404.2	99	55	154	0.8479969065549999	SG011	S32
2	113973574	114036527	ENSG00000125618.12	38	0	38	inf	SG011	S8
12	108681821	108733118	ENSG00000174600.9	13	49	62	-1.91427012597	SG021	S15
2	33661391	33789817	ENSG00000152689.13	61	196	257	-1.68397250655	SG069	S48
12	9868456	9885895	ENSG00000184293.3	14	39	53	-1.4780472968	SG037	S78
17	41277627	41305688	ENSG00000198496.6	45	17	62	1.4043902550799998	SG149	S66
2	242673994	242708226	ENSG00000180902.12	209	320	529	-0.6145689628059999	SG152	S70
17	37026112	37078023	ENSG00000002834.13	85	138	223	-0.69913352064	SG151	S65
15	50647606	50659636	ENSG00000244879.3	27	80	107	-1.5670405927200002	SG023	S96
20	34129770	34145405	ENSG00000125991.14	32	6	38	2.41503749928	SG023	S96
14	106355942	106362435	ENSG00000244620.1	113	19	132	2.5722514489700004	SG039	S75
22	42321045	42322822	ENSG00000159958.3	297	394	691	-0.407732698656	SG038	S52
21	42792231	42831141	ENSG00000157601.9	1523	1763	3286	-0.211116532833	SG069	S47
3	40498783	40503861	ENSG00000188846.9	146	237	383	-0.698918690018	SG023	S16
5	95860971	96115299	ENSG00000153113.19	384	175	559	1.13375138889	SG043	S62
16	70147529	70195203	ENSG00000090857.9	58	103	161	-0.8285195320559999	SG023	S39
2	120997640	121052289	ENSG00000144118.9	115	63	178	0.868210127444	SG040	S49
8	97238148	97247862	ENSG00000156467.5	65	18	83	1.85244281159	SG031	S46
17	78075355	78093678	ENSG00000171298.8	136	82	218	0.7299108366320001	SG040	S73
17	5008836	5026411	ENSG00000167840.9	30	5	35	2.58496250072	SG149	S89
22	22730355	22730874	ENSG00000211650.2	19	0	19	inf	SG149	S66
2	75061115	75120486	ENSG00000159399.5	261	341	602	-0.385721932454	SG031	S95
12	113376157	113411054	ENSG00000111331.8	640	765	1405	-0.257387842693	SG002	S72
2	85621871	85645555	ENSG00000042493.11	247	348	595	-0.494576264264	SG148	S67
9	127962821	127996437	ENSG00000136933.12	14	63	77	-2.16992500144	SG021	S15
17	76107881	76128439	ENSG00000141524.11	488	597	1085	-0.290849783702	SG045	S56
15	34671272	34880704	ENSG00000175265.13	154	40	194	1.94485844581	SG040	S50
8	99202061	99306621	ENSG00000104361.5	68	4	72	4.08746284125	SG023	S96
12	92536286	92539348	ENSG00000133639.3	449	658	1107	-0.5513721389940001	SG041	S59
12	113344582	113369990	ENSG00000089127.8	293	527	820	-0.846902297215	SG007	S30
2	89265781	89266286	ENSG00000239855.1	1356	1	1357	10.4051414631	SG007	S5
3	58318607	58411748	ENSG00000168297.11	43	103	146	-1.26023577248	SG038	S53
6	3023376	3024006	ENSG00000271361.1	3	20	23	-2.73696559417	SG025	S10
2	10443015	10567743	ENSG00000115756.8	149	58	207	1.36118752533	SG150	S93
1	111729796	111747157	ENSG00000162777.12	23	57	80	-1.30932805811	SG069	S47
X	71549366	71792953	ENSG00000147099.15	17	1	18	4.08746284125	SG152	S68
17	79648204	79650954	ENSG00000214087.4	57	14	71	2.02553509211	SG030	S43
5	180467225	180488523	ENSG00000165810.12	118	2	120	5.88264304936	SG038	S76
7	150076418	150109558	ENSG00000196456.4	47	106	153	-1.1733316028899998	SG150	S69
9	137533620	137736686	ENSG00000130635.11	6	27	33	-2.16992500144	SG151	S88
X	153715645	153719016	ENSG00000126903.11	13	0	13	inf	SG152	S68
2	131113580	131132982	ENSG00000072135.8	290	157	447	0.8852883411229999	SG031	S95
17	48623667	48633213	ENSG00000006282.15	154	37	191	2.05733317507	SG037	S54
5	82767284	82878122	ENSG00000038427.11	4	27	31	-2.7548875021599994	SG155	S42
6	37600284	37667082	ENSG00000112139.10	97	6	103	4.01495034147	SG042	S84
6	167342992	167370672	ENSG00000026297.11	1718	1418	3136	0.276872503899	SG031	S95
18	72163051	72188366	ENSG00000133313.10	262	457	719	-0.802627353521	SG039	S51
1	40538379	40563375	ENSG00000131238.12	97	152	249	-0.648014671256	SG011	S8
1	159032274	159116886	ENSG00000163568.9	20	64	84	-1.6780719051100002	SG152	S68
3	190931080	190952394	ENSG00000233308.1	12	46	58	-1.93859945534	SG069	S47
22	36649056	36663576	ENSG00000100342.16	21	60	81	-1.5145731728299998	SG043	S62
3	196669494	196670411	ENSG00000270170.1	81	43	124	0.913585248183	SG030	S21
20	361261	378203	ENSG00000101255.6	198	123	321	0.6868421147399999	SG027	S45
22	22730355	22730874	ENSG00000211650.2	0	89	89	-inf	SG031	S23
17	76481116	76493118	ENSG00000267432.1	228	35	263	2.70360699722	SG044	S63
15	34633917	34635378	ENSG00000182117.4	425	294	719	0.531646686189	SG148	S67
14	65381079	65411309	ENSG00000258289.3	73	36	109	1.01989955744	SG002	S31
2	231068340	231177930	ENSG00000079263.14	123	70	193	0.813231488394	SG037	S54
11	63991355	63993342	ENSG00000149743.9	12	36	48	-1.58496250072	SG023	S16
16	70147529	70195203	ENSG00000090857.9	217	142	359	0.61180411294	SG069	S47
14	96116838	96146170	ENSG00000187621.10	36	142	178	-1.97982211806	SG023	S39
1	111415775	111442550	ENSG00000143119.8	824	1043	1867	-0.340022915337	SG152	S91
19	44555520	44572144	ENSG00000178386.8	27	5	32	2.43295940728	SG030	S21
14	24759804	24769039	ENSG00000157379.9	58	24	82	1.27301849441	SG022	S11
5	6714718	6757161	ENSG00000112941.8	433	301	734	0.524603537967	SG150	S69
10	72432559	72522197	ENSG00000138316.6	52	2	54	4.70043971814	SG031	S95
6	159186773	159240444	ENSG00000092820.13	371	502	873	-0.43626817733	SG037	S54
17	5095379	5151364	ENSG00000261879.1	236	115	351	1.03715299842	SG044	S86
16	70190243	70207224	ENSG00000247228.2	526	349	875	0.591835763083	SG042	S60
14	23016447	23021097	ENSG00000229164.5	124	217	341	-0.807354922058	SG003	S27
2	131099923	131104197	ENSG00000136718.5	74	127	201	-0.779231321143	SG030	S20
22	29190543	29196585	ENSG00000100219.12	57	115	172	-1.01260003678	SG021	S15
16	67552321	67580691	ENSG00000039523.13	80	37	117	1.11247472926	SG148	S71
19	9523272	9546254	ENSG00000174652.13	159	87	246	0.869939459436	SG022	S12
22	37309670	37336491	ENSG00000100368.9	89	40	129	1.15380533608	SG148	S67
17	39777845	39943183	ENSG00000173801.12	1	21	22	-4.3923174227800015	SG003	S27
16	446725	460367	ENSG00000103202.8	165	260	425	-0.6560455987830001	SG027	S44
2	219081817	219119079	ENSG00000163466.11	72	124	196	-0.784271308945	SG002	S72
19	7701877	7712759	ENSG00000076944.10	269	125	394	1.10567807789	SG151	S64
7	97881691	97937000	ENSG00000164713.5	102	159	261	-0.640457613313	SG148	S71
5	6714718	6757161	ENSG00000112941.8	153	228	381	-0.575502171472	SG041	S82
3	122296449	122357894	ENSG00000173200.8	64	31	95	1.04580368961	SG024	S13
17	78174472	78179748	ENSG00000262580.1	54	21	75	1.36257007938	SG150	S69
7	150065278	150071133	ENSG00000214022.7	1478	1273	2751	0.215413850245	SG046	S57
5	122179134	122364999	ENSG00000064652.6	20	3	23	2.73696559417	SG022	S12
14	106370355	106370385	ENSG00000211923.1	21	1	22	4.3923174227800015	SG003	S27
1	182992595	183114727	ENSG00000135862.5	292	190	482	0.619968950549	SG031	S23
19	51322404	51327043	ENSG00000167748.6	597	428	1025	0.480120134864	SG150	S92
1	1634169	1655766	ENSG00000008128.18	146	42	188	1.7975071361	SG001	S26
11	60223225	60238233	ENSG00000156738.13	411	524	935	-0.350428417856	SG027	S44
2	33661391	33789817	ENSG00000152689.13	247	360	607	-0.543485864745	SG025	S10
13	77566740	77601330	ENSG00000005812.6	42	83	125	-0.982722008568	SG001	S1
8	564746	688106	ENSG00000104714.9	309	137	446	1.17343094494	SG044	S87
14	106383838	106391825	ENSG00000226777.3	597	112	709	2.41423219921	SG027	S45
8	11351510	11422113	ENSG00000136573.8	435	242	677	0.846008353461	SG002	S31
5	96211643	96255420	ENSG00000164308.12	488	111	599	2.13632147121	SG025	S34
22	22781876	22782371	ENSG00000211654.2	6	115	121	-4.26052755022	SG021	S14
1	167599330	167675486	ENSG00000198771.6	211	141	352	0.581547836308	SG006	S4
6	44225903	44233500	ENSG00000146232.10	138	81	219	0.768674453894	SG148	S94
16	3415099	3536960	ENSG00000262621.2	113	64	177	0.8201789624150001	SG030	S43
17	76142434	76162258	ENSG00000187997.7	97	47	144	1.04532399051	SG039	S75
1	161676762	161684142	ENSG00000132185.12	99	170	269	-0.780034316058	SG148	S67
11	60739115	60787849	ENSG00000013725.10	41	81	122	-0.982297998267	SG037	S78
9	123577774	123605262	ENSG00000095261.9	32	65	97	-1.0223678130299998	SG030	S43
5	10679342	10761384	ENSG00000112977.11	142	84	226	0.757429696726	SG011	S32
1	24291294	24307417	ENSG00000188529.10	0	23	23	-inf	SG006	S29
19	1275026	1279248	ENSG00000228300.9	70	127	197	-0.8594016698270001	SG040	S49
6	118228689	118638839	ENSG00000196376.6	15	0	15	inf	SG007	S5
5	156693089	156822541	ENSG00000055163.14	268	380	648	-0.503766417873	SG149	S66
7	97920963	98030380	ENSG00000006453.9	71	150	221	-1.0790715709899998	SG148	S71
8	28174503	28200872	ENSG00000168081.4	229	52	281	2.13876406996	SG002	S72
17	46210802	46507637	ENSG00000141293.11	89	40	129	1.15380533608	SG042	S83
5	179289066	179334859	ENSG00000197226.8	146	220	366	-0.5915351546450001	SG027	S44
X	129263337	129299861	ENSG00000156709.9	32	10	42	1.6780719051100002	SG046	S80
2	242673994	242708226	ENSG00000180902.12	398	258	656	0.62539736512	SG042	S60
6	116597741	116601066	ENSG00000189241.6	104	59	163	0.817796668779	SG021	S15
8	27348296	27403081	ENSG00000120915.9	43	89	132	-1.04946867626	SG031	S95
19	7684411	7694451	ENSG00000076924.7	58	100	158	-0.785875194647	SG043	S85
16	70190243	70207224	ENSG00000247228.2	175	294	469	-0.748461233004	SG149	S89
6	86370710	86388451	ENSG00000203875.6	616	157	773	1.9721657918	SG025	S33
6	167357853	167360151	ENSG00000197146.2	154	84	238	0.874469117916	SG031	S23
17	3575493	3599698	ENSG00000083454.17	76	206	282	-1.43857301374	SG148	S94
3	52558512	52569070	ENSG00000168268.6	49	163	212	-1.73401831012	SG007	S5
2	68592305	68624585	ENSG00000115956.9	2590	3350	5940	-0.371208997659	SG148	S71
6	89319985	89673348	ENSG00000111880.11	80	161	241	-1.00898878323	SG026	S17
3	13357737	13461809	ENSG00000132182.7	1088	1326	2414	-0.285402218862	SG043	S62
19	55896713	55914612	ENSG00000108107.8	810	1058	1868	-0.385345814342	SG043	S61
8	144655660	144659438	ENSG00000255050.1	74	1	75	6.209453365630001	SG007	S6
20	34894258	35157040	ENSG00000080845.13	17	0	17	inf	SG042	S84
20	61867235	61871859	ENSG00000101197.8	53	17	70	1.64045761331	SG041	S58
15	91073157	91188577	ENSG00000140577.11	75	147	222	-0.97085365434	SG031	S95
14	60610838	60636574	ENSG00000100612.9	34	79	113	-1.21631790693	SG027	S22
14	65381079	65411309	ENSG00000258289.3	78	31	109	1.33120590848	SG043	S85
11	7260009	7490273	ENSG00000170743.12	106	29	135	1.86993945944	SG031	S23
19	53097313	53193749	ENSG00000167766.14	59	109	168	-0.885541275415	SG037	S77
12	6560885	6575683	ENSG00000139192.7	376	290	666	0.374679761663	SG006	S4
18	67498394	67629039	ENSG00000150637.4	308	228	536	0.4338965265300001	SG042	S84
22	26847446	26879802	ENSG00000100099.16	31	65	96	-1.06817150264	SG046	S80
20	52553316	52687304	ENSG00000064787.8	6	25	31	-2.05889368905	SG002	S31
12	13080660	13137579	ENSG00000247498.5	0	16	16	-inf	SG043	S85
X	54834032	54842445	ENSG00000102316.12	380	52	432	2.86941589019	SG022	S35
17	48623667	48633213	ENSG00000006282.15	3	28	31	-3.22239242134	SG001	S25
4	39289076	39367995	ENSG00000035928.10	34	125	159	-1.87832144341	SG021	S14
16	70147529	70195203	ENSG00000090857.9	86	157	243	-0.86835599419	SG044	S87
7	1036622	1177896	ENSG00000146540.10	1421	1066	2487	0.414699116484	SG046	S57
X	71424510	71458897	ENSG00000186871.5	35	6	41	2.54432051622	SG022	S11
X	150564987	150577836	ENSG00000160131.9	18	0	18	inf	SG152	S70
11	34874641	34938046	ENSG00000149089.8	125	75	200	0.736965594166	SG040	S50
19	41256542	41271294	ENSG00000077312.4	61	106	167	-0.797183117	SG025	S10
X	11776278	11793870	ENSG00000005302.13	206	124	330	0.732304216796	SG022	S12
4	952675	980683	ENSG00000145214.9	21	66	87	-1.65207669658	SG044	S63
14	106452671	106453170	ENSG00000211934.2	42	4	46	3.39231742278	SG044	S87
6	86370710	86388451	ENSG00000203875.6	131	603	734	-2.20259119036	SG155	S42
7	75625656	75677322	ENSG00000127952.12	91	155	246	-0.7683297650759999	SG030	S21
17	80059336	80170706	ENSG00000176155.14	79	142	221	-0.845966371328	SG041	S58
X	128913955	128929177	ENSG00000122122.9	325	11	336	4.88486428928	SG152	S68
1	169631245	169823221	ENSG00000000460.12	700	413	1113	0.761213140413	SG030	S43
3	5229983	5261642	ENSG00000134109.6	1192	1384	2576	-0.215459707175	SG023	S39
7	1036622	1177896	ENSG00000146540.10	700	579	1279	0.273791573843	SG037	S54
4	154387498	154557863	ENSG00000121210.11	285	203	488	0.489482191867	SG042	S84
17	76481116	76493118	ENSG00000267432.1	37	12	49	1.62449086491	SG011	S8
16	18792617	18801705	ENSG00000134419.11	95	172	267	-0.856409146371	SG149	S66
11	2465914	2870339	ENSG00000053918.11	0	23	23	-inf	SG002	S7
1	227177566	227506175	ENSG00000143776.14	117	3	120	5.28540221886	SG030	S20
17	7362685	7387582	ENSG00000174282.7	18	1	19	4.16992500144	SG155	S42
17	46985731	47006418	ENSG00000159202.13	341	434	775	-0.34792330342	SG043	S61
19	18485541	18499986	ENSG00000130513.6	74	32	106	1.20945336563	SG030	S43
11	2316875	2324279	ENSG00000110665.7	44	2	46	4.45943161864	SG024	S13
14	73393040	73426411	ENSG00000119599.12	22	50	72	-1.18442457114	SG041	S59
17	38060848	38074903	ENSG00000073605.14	157	67	224	1.2285315584299998	SG148	S67
22	23222886	23223576	ENSG00000211673.2	476	699	1175	-0.554330882067	SG069	S48
X	12993227	12995346	ENSG00000205542.6	283	75	358	1.9158395523400005	SG038	S76
10	97512963	97849995	ENSG00000226688.2	480	361	841	0.4110355687210001	SG043	S61
22	42905974	42915808	ENSG00000189306.6	120	222	342	-0.887525270742	SG023	S96
4	38869298	38947360	ENSG00000197712.7	39	13	52	1.58496250072	SG039	S75
5	1456595	1524092	ENSG00000153395.5	705	854	1559	-0.276612812334	SG026	S18
19	50433021	50437192	ENSG00000169136.4	553	408	961	0.4387103282630001	SG042	S84
X	118672112	118699397	ENSG00000018610.9	1	38	39	-5.2479275134400005	SG022	S11
13	24995064	25086948	ENSG00000102699.5	250	160	410	0.643856189775	SG023	S39
5	153570290	153800544	ENSG00000164574.11	137	207	344	-0.595454874539	SG042	S60
4	75919087	75960034	ENSG00000248165.1	32	67	99	-1.06608919046	SG026	S18
1	28199055	28213196	ENSG00000130775.11	171	248	419	-0.536343795501	SG149	S89
19	39306062	39322645	ENSG00000104823.4	256	342	598	-0.417852514886	SG002	S31
22	43254393	43411151	ENSG00000100266.13	275	400	675	-0.540568381363	SG044	S86
21	45138975	45182188	ENSG00000160209.14	418	521	939	-0.317780430198	SG025	S33
17	5095379	5151364	ENSG00000261879.1	466	722	1188	-0.631668882233	SG038	S52
1	154554538	154600475	ENSG00000160710.11	1888	2111	3999	-0.161067813985	SG022	S35
19	18283972	18288927	ENSG00000216490.3	1931	1722	3653	0.165263021554	SG045	S79
14	66974125	67648520	ENSG00000171723.11	49	94	143	-0.939879007562	SG046	S57
17	79523913	79604172	ENSG00000182446.9	307	400	707	-0.381761344405	SG148	S67
2	61368732	61372104	ENSG00000212978.5	30	9	39	1.73696559417	SG038	S53
15	25277195	25281637	ENSG00000257151.1	12	0	12	inf	SG155	S42
10	122610722	122669036	ENSG00000120008.11	231	319	550	-0.465663572349	SG069	S47
17	7517428	7536700	ENSG00000129214.10	49	20	69	1.29278174923	SG003	S2
22	22550113	22550860	ENSG00000211640.3	31	367	398	-3.56543994246	SG045	S79
1	16944751	16961054	ENSG00000215908.5	124	48	172	1.36923380967	SG003	S27
2	101624079	101869263	ENSG00000204634.8	30	9	39	1.73696559417	SG003	S27
2	231068340	231177930	ENSG00000079263.14	77	130	207	-0.7555812723340001	SG149	S89
2	242673994	242708226	ENSG00000180902.12	155	75	230	1.0473057147799998	SG030	S20
16	2867164	2876305	ENSG00000007038.6	6	43	49	-2.84130225398	SG021	S15
8	11413760	11415470	ENSG00000255518.1	102	249	351	-1.2875765901	SG039	S51
22	23247030	23247205	ENSG00000211678.2	0	38	38	-inf	SG151	S65
5	115421171	115748459	ENSG00000145781.4	59	26	85	1.18220333122	SG039	S74
11	7448497	7533746	ENSG00000251364.2	88	25	113	1.81557542886	SG025	S10
19	50433021	50437192	ENSG00000169136.4	349	902	1251	-1.36990039705	SG023	S39
16	4511681	4545764	ENSG00000153406.9	84	45	129	0.900464326449	SG152	S91
5	96211643	96255420	ENSG00000164308.12	139	719	858	-2.3709068877200004	SG024	S36
1	44398992	44402913	ENSG00000117407.12	73	22	95	1.7303929402400002	SG043	S61
6	34247456	34360451	ENSG00000272325.1	110	167	277	-0.6023445789490001	SG151	S88
7	104581510	104602781	ENSG00000237513.1	19	1	20	4.2479275134400005	SG046	S57
6	10887064	10979553	ENSG00000153157.8	0	11	11	-inf	SG152	S70
7	150065278	150071133	ENSG00000214022.7	1025	1181	2206	-0.204385055004	SG151	S88
X	12885202	12908499	ENSG00000196664.4	40	8	48	2.32192809489	SG069	S24
2	219081817	219119079	ENSG00000163466.11	187	94	281	0.99230560821	SG040	S50
10	29698331	29776674	ENSG00000224597.5	8	40	48	-2.32192809489	SG152	S70
16	68344877	68392230	ENSG00000132600.12	111	66	177	0.7500217469920001	SG044	S86
4	75858305	75975325	ENSG00000169116.7	183	321	504	-0.810729648838	SG038	S76
13	75858808	76056250	ENSG00000136111.8	35	226	261	-2.69089594547	SG044	S63
10	3183930	3210164	ENSG00000237399.3	218	87	305	1.32524082893	SG006	S4
22	22657589	22664766	ENSG00000272779.1	10	40	50	-2.0	SG024	S13
4	147096837	147121152	ENSG00000164167.5	72	130	202	-0.852442811586	SG007	S6
20	57393974	57425958	ENSG00000235590.3	0	17	17	-inf	SG039	S75
1	110452864	110473614	ENSG00000184371.9	31	70	101	-1.17508670656	SG039	S74
6	3832167	3855971	ENSG00000238158.2	0	20	20	-inf	SG022	S11
8	97273943	97349223	ENSG00000156471.8	5	26	31	-2.37851162325	SG031	S46
5	304291	438406	ENSG00000063438.12	436	328	764	0.410632320159	SG149	S66
15	40327940	40331389	ENSG00000140319.6	393	281	674	0.483959182038	SG011	S8
8	145515280	145538252	ENSG00000185122.6	19	0	19	inf	SG045	S55
4	113195698	113207059	ENSG00000145365.10	234	157	391	0.575743970692	SG151	S64
X	118533023	118588441	ENSG00000077713.14	62	0	62	inf	SG152	S70
22	43088127	43117304	ENSG00000128274.11	144	66	210	1.12553088208	SG025	S10
17	18086392	18113268	ENSG00000091542.8	270	189	459	0.51457317283	SG001	S1
1	203274619	203278730	ENSG00000159388.5	111	50	161	1.15055967658	SG037	S78
22	17517460	17541715	ENSG00000237438.2	120	42	162	1.5145731728299998	SG025	S33
1	227177566	227506175	ENSG00000143776.14	12	0	12	inf	SG026	S17
15	81451916	81601393	ENSG00000172349.12	173	89	262	0.95889479667	SG043	S61
12	129277739	129308528	ENSG00000139370.6	93	155	248	-0.736965594166	SG025	S33
19	2037470	2051243	ENSG00000099875.10	45	90	135	-1.0	SG045	S56
15	34633917	34635378	ENSG00000182117.4	328	234	562	0.487187285035	SG148	S94
2	25643986	25650512	ENSG00000224220.1	239	46	285	2.37730485192	SG155	S42
12	10705962	10710648	ENSG00000256039.1	0	19	19	-inf	SG001	S25
14	107178820	107179338	ENSG00000211974.2	26	0	26	inf	SG041	S59
5	175810949	175815976	ENSG00000048162.15	177	285	462	-0.687212558969	SG044	S63
5	1456595	1524092	ENSG00000153395.5	514	346	860	0.570996321557	SG024	S13
X	153172821	153193873	ENSG00000089820.11	151	26	177	2.53796502118	SG031	S23
3	194123401	194215009	ENSG00000133657.10	77	41	118	0.909234536077	SG155	S19
19	49403307	49426629	ENSG00000104805.11	432	310	742	0.478763096889	SG045	S79
1	160185505	160232190	ENSG00000132716.14	14	1	15	3.80735492206	SG046	S81
X	108779010	108787919	ENSG00000101888.7	12	0	12	inf	SG152	S70
5	179224597	179233934	ENSG00000161013.12	94	149	243	-0.664579668785	SG044	S86
16	85932409	85956215	ENSG00000140968.6	357	465	822	-0.381306641966	SG155	S42
7	76940068	77045717	ENSG00000186088.11	35	73	108	-1.06054154194	SG023	S39
12	113345433	113455556	ENSG00000257452.1	2132	2456	4588	-0.20410312261100005	SG043	S62
2	219081817	219119079	ENSG00000163466.11	118	58	176	1.02466205423	SG021	S38
1	2488136	2496821	ENSG00000157873.13	1184	1020	2204	0.21509992877	SG043	S85
12	121647660	121671909	ENSG00000135124.10	30	66	96	-1.13750352375	SG002	S72
X	102930424	102941746	ENSG00000123562.12	72	17	89	2.0824621601900004	SG038	S76
2	179390716	179690222	ENSG00000155657.19	52	20	72	1.37851162325	SG152	S91
11	43577986	43878160	ENSG00000149084.7	107	166	273	-0.633572444946	SG038	S52
12	131438452	131626014	ENSG00000111452.8	6	52	58	-3.11547721742	SG155	S42
11	62619460	62623386	ENSG00000255717.2	46	102	148	-1.14886338591	SG025	S34
22	37611778	37611931	ENSG00000226233.1	2	18	20	-3.16992500144	SG011	S8
2	160175490	160472071	ENSG00000123636.13	5	23	28	-2.20163386117	SG037	S78
8	28174503	28200872	ENSG00000168081.4	136	51	187	1.41503749928	SG002	S7
16	19714902	19729016	ENSG00000103550.9	12	49	61	-2.02974734339	SG151	S88
17	16826229	16838153	ENSG00000128438.6	251	368	619	-0.5520184021060001	SG152	S91
9	139270029	139293249	ENSG00000165684.3	59	112	171	-0.924711872696	SG069	S24
17	73872574	73875627	ENSG00000267801.1	1	16	17	-4.0	SG151	S65
1	200938520	200992828	ENSG00000116852.10	83	160	243	-0.94688866354	SG044	S63
1	93727743	93811444	ENSG00000223745.3	283	141	424	1.00510689043	SG038	S76
2	89512908	89513413	ENSG00000244575.1	1	14	15	-3.80735492206	SG045	S79
19	36195429	36207940	ENSG00000011590.9	77	124	201	-0.687409769692	SG046	S81
19	13885097	13889276	ENSG00000104979.4	258	388	646	-0.588685586764	SG031	S95
19	18485541	18499986	ENSG00000130513.6	39	85	124	-1.1239887172799998	SG069	S24
X	13395307	13421138	ENSG00000226434.1	114	0	114	inf	SG022	S35
15	75128457	75135538	ENSG00000140474.8	59	106	165	-0.8452774052009999	SG040	S73
19	571297	583493	ENSG00000172270.14	793	937	1730	-0.240728181955	SG040	S73
10	11784365	11806069	ENSG00000134463.10	18	1	19	4.16992500144	SG155	S42
1	233086351	233119180	ENSG00000135778.7	14	49	63	-1.80735492206	SG011	S9
20	43595115	43708600	ENSG00000101109.7	197	129	326	0.610824564033	SG026	S17
4	113195698	113207059	ENSG00000145365.10	136	202	338	-0.570748641501	SG027	S44
22	43547520	43559248	ENSG00000100300.13	66	139	205	-1.07454695337	SG006	S29
22	22516592	22517074	ENSG00000211639.2	0	27	27	-inf	SG031	S23
X	48438162	48439545	ENSG00000228343.1	23	4	27	2.52356195606	SG038	S53
7	30323923	30452118	ENSG00000180233.9	23	54	77	-1.23132554611	SG042	S84
5	95860971	96115299	ENSG00000153113.19	230	150	380	0.616671360448	SG155	S42
2	239133193	239140318	ENSG00000186235.6	21	0	21	inf	SG044	S63
6	26365387	26378546	ENSG00000186470.9	62	474	536	-2.93454693851	SG011	S8
19	51322404	51327043	ENSG00000167748.6	361	642	1003	-0.8305744602349999	SG044	S87
1	24197016	24285549	ENSG00000188822.6	136	217	353	-0.674088391194	SG044	S87
1	155286654	155291478	ENSG00000225855.2	18	1	19	4.16992500144	SG046	S81
7	142498725	142500432	ENSG00000211772.4	0	11	11	-inf	SG069	S48
22	17517460	17541715	ENSG00000237438.2	66	147	213	-1.15527822548	SG046	S81
3	192514604	192635950	ENSG00000180611.6	0	16	16	-inf	SG041	S59
6	89855769	89875284	ENSG00000146281.5	55	13	68	2.08091999538	SG152	S70
19	40170014	40177013	ENSG00000226025.5	60	22	82	1.44745897697	SG037	S77
1	161551101	161648444	ENSG00000072694.14	55	17	72	1.69389687227	SG151	S64
5	81569177	81574396	ENSG00000186468.8	80	29	109	1.46394709976	SG023	S16
8	142402093	142441620	ENSG00000184489.7	62	13	75	2.25375659225	SG043	S62
21	47608055	47648738	ENSG00000160285.10	303	192	495	0.658211482752	SG025	S34
16	84599200	84651683	ENSG00000103187.6	1030	819	1849	0.33070898043	SG022	S12
1	11903761	11908136	ENSG00000242349.1	22	3	25	2.87446911792	SG003	S3
20	34213953	34252878	ENSG00000214078.7	309	156	465	0.986060809042	SG041	S82
15	95024040	95027181	ENSG00000260359.1	44	15	59	1.55254102303	SG046	S80
11	7506619	7532608	ENSG00000183801.3	1	14	15	-3.80735492206	SG046	S80
14	39866873	39901704	ENSG00000165355.7	12	0	12	inf	SG041	S58
11	418263	442011	ENSG00000185101.8	161	240	401	-0.575973717494	SG150	S69
19	54024235	54083523	ENSG00000130844.12	22	53	75	-1.26848883593	SG021	S38
22	42262835	42303312	ENSG00000198911.7	193	63	256	1.61517711377	SG040	S73
13	43460524	43566385	ENSG00000133106.10	271	196	467	0.467439197239	SG044	S86
19	35505865	35516239	ENSG00000271032.1	65	111	176	-0.7720480533220001	SG027	S44
5	180467225	180488523	ENSG00000165810.12	14	0	14	inf	SG039	S74
21	43916118	44001550	ENSG00000160190.9	152	237	389	-0.640815735455	SG003	S27
19	41903385	41930910	ENSG00000248098.6	83	27	110	1.6201519291799995	SG039	S75
16	3486104	3493542	ENSG00000167981.4	14	0	14	inf	SG040	S49
21	46305868	46351904	ENSG00000160255.12	41	114	155	-1.4753380095500002	SG040	S73
12	77415027	77459360	ENSG00000165891.11	53	23	76	1.2043584985100002	SG001	S25
8	145051321	145086940	ENSG00000178685.9	424	564	988	-0.411630897836	SG038	S76
8	144989321	145050902	ENSG00000178209.10	283	381	664	-0.428988944661	SG037	S78
2	113973574	114036527	ENSG00000125618.12	11	35	46	-1.66985139831	SG040	S50
19	9523272	9546254	ENSG00000174652.13	72	134	206	-0.8961641890150001	SG152	S68
16	70190243	70207224	ENSG00000247228.2	125	214	339	-0.7756827017389999	SG023	S96
9	123664671	123691451	ENSG00000056558.6	1025	746	1771	0.458376374138	SG041	S82
17	48623667	48633213	ENSG00000006282.15	47	6	53	2.96962635096	SG069	S47
11	17229700	17371521	ENSG00000070081.11	10	54	64	-2.43295940728	SG043	S61
6	2854896	2881641	ENSG00000230438.5	18	50	68	-1.47393118833	SG046	S57
22	42905974	42915808	ENSG00000189306.6	95	42	137	1.17753818555	SG043	S85
7	142498725	142500432	ENSG00000211772.4	17	0	17	inf	SG039	S74
9	107526438	107539738	ENSG00000165028.7	32	5	37	2.67807190511	SG002	S72
5	150591711	150650001	ENSG00000196743.4	383	278	661	0.462259509201	SG023	S16
1	8921061	8939308	ENSG00000074800.9	375	205	580	0.8712666858779999	SG148	S94
3	192514604	192635950	ENSG00000180611.6	0	42	42	-inf	SG043	S62
19	55155340	55181810	ENSG00000186818.8	156	66	222	1.2410080995	SG148	S71
11	117671559	117699413	ENSG00000137731.9	60	26	86	1.20645087747	SG149	S89
1	2115903	2139172	ENSG00000162585.12	116	60	176	0.951090399519	SG042	S84
22	23521891	23660224	ENSG00000186716.15	7	30	37	-2.09953567355	SG022	S35
10	135093135	135125219	ENSG00000130640.9	101	157	258	-0.6364092661399999	SG001	S26
6	3020388	3022984	ENSG00000270346.1	21	3	24	2.80735492206	SG024	S13
12	39040624	39301232	ENSG00000139117.9	33	10	43	1.72246602447	SG031	S46
2	242045514	242088919	ENSG00000115687.9	180	304	484	-0.756074417114	SG069	S47
1	21766621	21811498	ENSG00000142794.14	0	11	11	-inf	SG148	S71
2	231068340	231177930	ENSG00000079263.14	123	223	346	-0.858385394581	SG011	S8
16	11343506	11445619	ENSG00000175643.7	118	60	178	0.975752453753	SG030	S20
19	18682540	18688360	ENSG00000221983.3	581	433	1014	0.424171138678	SG006	S29
2	132250386	132279146	ENSG00000152117.13	8	43	51	-2.4262647547	SG045	S55
18	12991361	13125051	ENSG00000101639.14	164	97	261	0.757639162431	SG044	S63
12	129277739	129308528	ENSG00000139370.6	471	331	802	0.508895842806	SG151	S88
11	6947635	7005863	ENSG00000149054.10	2	18	20	-3.16992500144	SG002	S72
1	111415775	111442550	ENSG00000143119.8	755	1000	1755	-0.40545145045	SG155	S41
12	42475647	42538681	ENSG00000151233.6	38	5	43	2.92599941856	SG024	S37
22	45559722	45583896	ENSG00000093000.14	151	94	245	0.683815887647	SG038	S52
17	29096406	29151794	ENSG00000176390.10	103	158	261	-0.617280220994	SG025	S34
1	7844380	7905237	ENSG00000049246.10	1	23	24	-4.52356195606	SG022	S12
19	54024235	54083523	ENSG00000130844.12	66	6	72	3.45943161864	SG152	S68
21	47706251	47717665	ENSG00000182362.9	61	29	90	1.07275634244	SG024	S13
17	75276651	75496678	ENSG00000184640.13	856	709	1565	0.271825169162	SG148	S94
21	42792231	42831141	ENSG00000157601.9	1017	1287	2304	-0.33969237436300004	SG003	S3
8	91634223	91803777	ENSG00000180694.9	2	17	19	-3.08746284125	SG155	S42
1	87328132	87380107	ENSG00000183291.11	118	67	185	0.8165538589040001	SG045	S56
8	103540968	103550896	ENSG00000253633.1	9	31	40	-1.7842713089400002	SG151	S65
14	96116838	96146170	ENSG00000187621.10	212	81	293	1.3880704516799998	SG022	S11
12	109038885	109125372	ENSG00000110880.6	105	59	164	0.8316024683040001	SG030	S21
14	93170152	93215047	ENSG00000100600.10	208	349	557	-0.7466435080689999	SG046	S80
14	106452671	106453170	ENSG00000211934.2	107	0	107	inf	SG041	S59
19	983174	994569	ENSG00000065268.6	106	163	269	-0.620807699668	SG039	S51
22	36649056	36663576	ENSG00000100342.16	294	201	495	0.548620653657	SG002	S31
15	63900817	64126141	ENSG00000103657.9	70	157	227	-1.16533773195	SG069	S48
1	182992595	183114727	ENSG00000135862.5	325	217	542	0.582744675471	SG069	S47
17	5264258	5322960	ENSG00000108559.7	452	354	806	0.352573412332	SG021	S14
4	952675	980683	ENSG00000145214.9	74	33	107	1.16505924627	SG007	S6
19	54960224	54972980	ENSG00000167615.12	589	993	1582	-0.753526083698	SG046	S57
14	93673440	93695561	ENSG00000012963.9	61	117	178	-0.939627382021	SG069	S47
17	43129030	43186334	ENSG00000136448.7	346	440	786	-0.346731485888	SG044	S87
3	184016497	184026842	ENSG00000175166.12	92	147	239	-0.6761103887790001	SG006	S4
18	5232875	5246507	ENSG00000263753.2	80	132	212	-0.722466024471	SG024	S37
19	18417040	18434084	ENSG00000130520.6	34	11	45	1.62803122261	SG026	S18
1	236681300	236716281	ENSG00000116977.14	570	447	1017	0.350687087869	SG021	S14
17	76419778	76573476	ENSG00000187775.12	12	53	65	-2.14295795384	SG150	S92
10	97951458	98031344	ENSG00000095585.12	180	115	295	0.646363045385	SG152	S68
4	17461884	17513857	ENSG00000151552.7	47	91	138	-0.953205788521	SG039	S51
11	57174427	57195053	ENSG00000134802.13	67	31	98	1.11189288007	SG041	S58
10	105348285	105615301	ENSG00000107957.12	84	141	225	-0.74723392962	SG040	S50
12	6571489	6580153	ENSG00000139190.12	159	101	260	0.6546714725330001	SG027	S45
7	45002261	45018697	ENSG00000136286.10	1620	1390	3010	0.220908930161	SG148	S71
6	26055968	26056699	ENSG00000187837.2	122	71	193	0.7809902180580001	SG152	S68
X	131337053	131353471	ENSG00000123728.5	65	25	90	1.37851162325	SG069	S48
19	9523272	9546254	ENSG00000174652.13	43	98	141	-1.18844508941	SG152	S91
X	15739620	15805747	ENSG00000169239.8	2	24	26	-3.58496250072	SG152	S70
2	152266397	152364518	ENSG00000080345.13	127	74	201	0.779231321143	SG151	S64
6	24403153	24425810	ENSG00000124532.10	29	65	94	-1.1643868179	SG023	S96
2	242011584	242041747	ENSG00000122085.12	119	189	308	-0.667424660913	SG027	S22
9	90112143	90323548	ENSG00000196730.8	99	171	270	-0.788495894806	SG025	S33
20	37049235	37063996	ENSG00000196756.7	85	174	259	-1.03355255971	SG003	S3
6	18224099	18265054	ENSG00000124795.10	129	82	211	0.653675250805	SG022	S35
14	23242431	23299029	ENSG00000155465.14	183	67	250	1.44961064783	SG041	S58
6	154708638	154831793	ENSG00000153721.13	22	51	73	-1.21299372333	SG043	S62
X	128913955	128929177	ENSG00000122122.9	126	334	460	-1.4064243689700002	SG003	S27
2	71291474	71306935	ENSG00000124357.8	124	302	426	-1.28420842894	SG021	S14
3	167967310	168548387	ENSG00000206120.7	27	6	33	2.16992500144	SG152	S70
21	15857549	15955723	ENSG00000155307.13	66	128	194	-0.955605880642	SG151	S65
15	34671272	34880704	ENSG00000175265.13	167	58	225	1.52572329735	SG038	S52
10	91087651	91100728	ENSG00000119917.9	340	452	792	-0.410788026277	SG030	S20
X	31115794	33357558	ENSG00000198947.10	21	3	24	2.80735492206	SG069	S47
2	64319786	64371588	ENSG00000197329.7	152	94	246	0.6933386617659999	SG002	S72
1	89646831	89664615	ENSG00000162654.8	13	42	55	-1.6918777046399998	SG027	S44
17	4848947	4852356	ENSG00000108518.7	1450	1757	3207	-0.277061291106	SG007	S6
10	81272357	81276188	ENSG00000253626.2	0	12	12	-inf	SG025	S10
16	1494935	1525581	ENSG00000103249.13	224	140	364	0.678071905113	SG021	S38
18	12991361	13125051	ENSG00000101639.14	104	198	302	-0.928916901939	SG148	S71
14	20724717	20773888	ENSG00000136319.7	41	79	120	-0.946228743559	SG155	S19
1	9294834	9331396	ENSG00000049239.8	111	65	176	0.7720480533220001	SG021	S38
19	54024235	54083523	ENSG00000130844.12	32	8	40	2.0	SG030	S21
16	24930706	25026987	ENSG00000140750.12	32	71	103	-1.1497471195	SG002	S72
1	213025450	213031430	ENSG00000198468.3	8	31	39	-1.95419631039	SG155	S41
1	16944751	16961054	ENSG00000215908.5	97	30	127	1.69302224658	SG030	S21
12	124105489	124118313	ENSG00000111361.8	142	203	345	-0.51558879768	SG040	S50
16	57392684	57400102	ENSG00000102962.4	484	336	820	0.526545814496	SG025	S10
19	50433021	50437192	ENSG00000169136.4	708	336	1044	1.0752881273	SG046	S80
19	18390563	18392432	ENSG00000130522.4	61	125	186	-1.0350469471	SG149	S66
14	106494135	106494597	ENSG00000211937.2	62	22	84	1.4947646917500002	SG148	S71
3	57994127	58157982	ENSG00000136068.10	46	84	130	-0.868755466722	SG003	S3
19	18682540	18688360	ENSG00000221983.3	609	470	1079	0.373781471341	SG155	S41
1	213123862	213165379	ENSG00000143494.11	89	28	117	1.66837850891	SG040	S49
17	36891298	36904631	ENSG00000056661.9	67	29	96	1.20810819533	SG069	S24
17	80005778	80009610	ENSG00000169733.7	118	72	190	0.7127180479199999	SG021	S38
12	113345433	113455556	ENSG00000257452.1	3640	4701	8341	-0.369029230108	SG025	S33
10	105348285	105615301	ENSG00000107957.12	85	183	268	-1.10630890215	SG040	S49
17	56402811	56472371	ENSG00000265148.1	63	114	177	-0.8556100906649999	SG043	S85
11	8986321	8999074	ENSG00000254860.1	1	16	17	-4.0	SG025	S10
17	5095379	5151364	ENSG00000261879.1	115	190	305	-0.724365557387	SG001	S1
19	18682540	18688360	ENSG00000221983.3	603	469	1072	0.362570079385	SG026	S18
22	31003071	31023265	ENSG00000185339.4	108	45	153	1.2630344058299998	SG043	S62
X	129198849	129244691	ENSG00000102034.12	40	130	170	-1.7004397181400002	SG007	S6
12	15094951	15114662	ENSG00000111348.4	593	737	1330	-0.313632514549	SG024	S36
10	72238577	72328205	ENSG00000107719.8	136	19	155	2.83953532781	SG031	S95
22	43562628	43583139	ENSG00000100304.12	127	65	192	0.966316873744	SG039	S74
20	2632791	2639039	ENSG00000101361.10	197	138	335	0.513527362678	SG046	S57
5	1456595	1524092	ENSG00000153395.5	429	321	750	0.418404350377	SG027	S22
11	75145685	75236948	ENSG00000158555.10	30	6	36	2.32192809489	SG155	S41
12	569530	672675	ENSG00000139044.6	19	1	20	4.2479275134400005	SG002	S7
7	134777115	134855547	ENSG00000122783.12	422	280	702	0.5918161717620001	SG021	S14
17	76107881	76128439	ENSG00000141524.11	237	319	556	-0.428669364867	SG039	S74
15	75648133	75660495	ENSG00000140400.10	94	34	128	1.46712601043	SG026	S18
5	1568637	1594735	ENSG00000185986.10	29	65	94	-1.1643868179	SG069	S47
4	110481361	110609784	ENSG00000005059.11	174	263	437	-0.595975493444	SG025	S33
7	117824086	117832878	ENSG00000128534.3	114	66	180	0.788495894806	SG030	S43
12	108916357	108955176	ENSG00000075856.7	128	189	317	-0.562242424221	SG023	S16
2	113973574	114036527	ENSG00000125618.12	77	1	78	6.26678654069	SG026	S18
7	64139332	64147771	ENSG00000271550.1	79	13	92	2.60334103004	SG152	S70
3	186648274	186796341	ENSG00000073849.10	85	44	129	0.9499593175	SG045	S56
5	180467225	180488523	ENSG00000165810.12	43	10	53	2.10433665981	SG148	S94
6	42931619	42946958	ENSG00000124587.9	40	76	116	-0.925999418556	SG039	S74
2	64370373	64479993	ENSG00000225889.3	77	168	245	-1.12553088208	SG024	S13
1	160965001	160991138	ENSG00000158769.13	41	14	55	1.5501970825600002	SG031	S46
2	242673994	242708226	ENSG00000180902.12	354	261	615	0.439699553513	SG042	S84
19	10444452	10450499	ENSG00000076662.5	314	235	549	0.418103802327	SG027	S45
19	2071037	2096331	ENSG00000172081.9	282	171	453	0.7216988375130001	SG027	S44
4	42399856	42404504	ENSG00000178343.4	3	31	34	-3.36923380967	SG043	S62
13	46916139	46964177	ENSG00000102445.14	72	29	101	1.31194400631	SG149	S89
7	99798276	99844171	ENSG00000239521.3	73	124	197	-0.764371751507	SG006	S28
3	156257929	156272973	ENSG00000114850.2	483	636	1119	-0.397003576449	SG027	S44
17	79523913	79604172	ENSG00000182446.9	232	327	559	-0.495165830371	SG148	S94
2	113973574	114036527	ENSG00000125618.12	38	0	38	inf	SG155	S42
3	126707437	126756235	ENSG00000114554.7	70	31	101	1.17508670656	SG031	S46
22	23247030	23247205	ENSG00000211678.2	0	47	47	-inf	SG155	S41
21	43916118	44001550	ENSG00000160190.9	318	229	547	0.473679167187	SG069	S48
5	96149731	96271097	ENSG00000247121.2	238	56	294	2.08746284125	SG031	S23
3	127783621	127872757	ENSG00000175792.7	138	200	338	-0.535331732997	SG043	S62
22	36622256	36636000	ENSG00000128335.9	215	143	358	0.588321512811	SG023	S96
1	31205316	31230667	ENSG00000162511.7	1306	1484	2790	-0.184336195074	SG023	S96
22	25844072	25916821	ENSG00000100058.8	106	58	164	0.869939459436	SG002	S72
22	50686121	50700254	ENSG00000188130.9	341	221	562	0.625725369633	SG042	S60
15	90773207	90776935	ENSG00000185043.6	22	69	91	-1.64909283814	SG002	S72
19	2977444	2995177	ENSG00000104953.14	5	26	31	-2.37851162325	SG030	S43
1	39997510	40024379	ENSG00000243970.1	0	27	27	-inf	SG152	S68
11	6947635	7005863	ENSG00000149054.10	11	33	44	-1.58496250072	SG043	S61
9	117904097	118164923	ENSG00000173077.10	29	0	29	inf	SG039	S74
7	128594948	128695198	ENSG00000064419.9	380	292	672	0.380031049451	SG148	S71
1	181143620	181151344	ENSG00000237292.1	3	24	27	-3.0	SG148	S94
5	150591711	150650001	ENSG00000196743.4	233	320	553	-0.457741950233	SG027	S22
11	62619460	62623386	ENSG00000255717.2	32	81	113	-1.3398500028799998	SG152	S91
11	2316875	2324279	ENSG00000110665.7	17	0	17	inf	SG155	S42
16	89627065	89630950	ENSG00000167526.9	273	191	464	0.515328312884	SG038	S76
11	87846410	87908635	ENSG00000123892.7	32	72	104	-1.16992500144	SG040	S50
14	106355942	106362435	ENSG00000244620.1	22	62	84	-1.4947646917500002	SG041	S82
1	40538379	40563375	ENSG00000131238.12	166	87	253	0.932095935498	SG043	S85
1	213025450	213031430	ENSG00000198468.3	12	47	59	-1.96962635096	SG041	S59
19	55896713	55914612	ENSG00000108107.8	341	481	822	-0.496265154746	SG069	S47
X	13396854	13397459	ENSG00000197582.5	0	90	90	-inf	SG040	S49
3	122246771	122283084	ENSG00000138496.12	110	199	309	-0.855264907019	SG041	S58
13	21727734	21750741	ENSG00000165480.11	188	26	214	2.8541491335400004	SG045	S56
14	77564440	77583630	ENSG00000198894.3	39	82	121	-1.07214978576	SG150	S69
10	125767184	125853206	ENSG00000182022.13	30	5	35	2.58496250072	SG022	S12
3	186648274	186796341	ENSG00000073849.10	1133	823	1956	0.461183525399	SG006	S28
20	5080486	5093749	ENSG00000089063.10	17	64	81	-1.91253715875	SG046	S81
20	33703167	33735167	ENSG00000088298.8	28	62	90	-1.14684138833	SG011	S8
14	93170152	93215047	ENSG00000100600.10	254	176	430	0.5292530681350001	SG042	S83
11	43851259	43902276	ENSG00000246250.2	105	60	165	0.807354922058	SG023	S96
13	46924248	46936733	ENSG00000241353.2	42	16	58	1.39231742278	SG150	S69
19	41903385	41930910	ENSG00000248098.6	18	58	76	-1.68805599369	SG148	S94
9	136627016	136857726	ENSG00000160293.12	258	356	614	-0.4645061755430001	SG038	S52
12	68383225	68628466	ENSG00000255733.1	19	52	71	-1.4525122047	SG046	S80
X	55478538	55479998	ENSG00000187601.3	12	50	62	-2.05889368905	SG003	S3
4	153021906	153025872	ENSG00000245954.2	14	0	14	inf	SG001	S1
2	113914902	113966973	ENSG00000125637.11	567	465	1032	0.286118018947	SG148	S71
19	17516503	17529713	ENSG00000269640.1	192	103	295	0.898461973538	SG152	S70
X	55744172	55785207	ENSG00000083750.8	1	21	22	-4.3923174227800015	SG007	S30
1	40222854	40254533	ENSG00000116985.6	3	21	24	-2.80735492206	SG011	S32
19	55896713	55914612	ENSG00000108107.8	500	383	883	0.384583702737	SG011	S8
17	49242796	49249108	ENSG00000243678.7	350	501	851	-0.517455681363	SG037	S54
3	8792094	8811314	ENSG00000180914.6	35	10	45	1.80735492206	SG002	S31
7	134777115	134855547	ENSG00000122783.12	444	344	788	0.368151111648	SG042	S83
11	7448497	7533746	ENSG00000251364.2	38	12	50	1.6629650127200002	SG027	S22
7	6201407	6312275	ENSG00000008256.11	18	48	66	-1.41503749928	SG041	S59
4	102332443	102995969	ENSG00000153064.7	16	62	78	-1.95419631039	SG021	S15
3	121350246	121379774	ENSG00000180353.6	1001	1306	2307	-0.38371292271	SG046	S57
20	36322408	36500531	ENSG00000132792.14	35	12	47	1.54432051622	SG038	S53
10	29698331	29776674	ENSG00000224597.5	4	36	40	-3.16992500144	SG152	S68
1	167599330	167675486	ENSG00000198771.6	281	154	435	0.867639779526	SG069	S24
16	89642176	89663654	ENSG00000178773.10	78	33	111	1.2410080995	SG046	S80
8	98787285	98865241	ENSG00000104341.12	29	83	112	-1.51705843622	SG045	S56
3	98239976	98312567	ENSG00000080819.2	259	369	628	-0.510668718374	SG069	S48
20	52169309	52191847	ENSG00000197670.5	70	118	188	-0.7533600324169999	SG038	S52
10	124608594	124639157	ENSG00000213185.2	6	24	30	-2.0	SG152	S91
1	111415775	111442550	ENSG00000143119.8	370	504	874	-0.445898462984	SG040	S50
8	8640864	8751155	ENSG00000147324.6	163	100	263	0.704871964456	SG043	S62
6	2887500	2903514	ENSG00000170542.5	366	194	560	0.915786996097	SG039	S75
15	90773207	90776935	ENSG00000185043.6	49	21	70	1.22239242134	SG003	S3
14	107178820	107179338	ENSG00000211974.2	1	38	39	-5.2479275134400005	SG149	S90
9	137533620	137736686	ENSG00000130635.11	30	295	325	-3.2976805486400003	SG149	S89
8	120569326	120685693	ENSG00000136960.8	25	5	30	2.32192809489	SG025	S10
19	983174	994569	ENSG00000065268.6	130	194	324	-0.577545029159	SG003	S27
1	160965001	160991138	ENSG00000158769.13	78	38	116	1.0374747054200002	SG042	S60
12	93936239	93965099	ENSG00000246985.3	14	1	15	3.80735492206	SG022	S11
8	11700033	11726957	ENSG00000164733.16	179	325	504	-0.860480130652	SG007	S30
12	56510370	56511727	ENSG00000229117.4	65	23	88	1.49880585697	SG045	S56
X	14026398	14048012	ENSG00000046647.9	3	47	50	-3.96962635096	SG152	S70
X	73012040	73048902	ENSG00000270641.1	17	62	79	-1.86673346914	SG003	S2
5	71403061	71505395	ENSG00000131711.10	20	2	22	3.32192809489	SG022	S12
10	3179920	3215003	ENSG00000107959.11	208	287	495	-0.464467208535	SG027	S44
17	5112256	5138155	ENSG00000161929.10	214	142	356	0.591719866896	SG069	S24
2	46717889	46769696	ENSG00000250565.2	6	25	31	-2.05889368905	SG152	S68
17	73521161	73571289	ENSG00000073350.9	4	29	33	-2.85798099513	SG043	S61
14	92582466	92588261	ENSG00000183648.5	238	158	396	0.5910370151309999	SG024	S36
1	206238872	206288647	ENSG00000196533.6	98	55	153	0.833350130591	SG155	S19
19	55128612	55148979	ENSG00000104972.10	418	208	626	1.00691941394	SG152	S70
16	16043434	16236931	ENSG00000103222.14	142	223	365	-0.651152780416	SG041	S59
22	22781876	22782371	ENSG00000211654.2	21	0	21	inf	SG023	S39
12	6554033	6560855	ENSG00000139193.3	370	228	598	0.6984914463519999	SG022	S11
12	4361901	4384231	ENSG00000255920.1	66	111	177	-0.7500217469920001	SG022	S35
3	122399465	122449687	ENSG00000173193.9	357	271	628	0.397631222675	SG030	S43
9	6716548	6727438	ENSG00000225489.2	7	29	36	-2.05062607307	SG152	S91
X	118892576	118894164	ENSG00000187808.3	21	4	25	2.39231742278	SG044	S63
11	62457747	62477317	ENSG00000168000.10	28	123	151	-2.13515958328	SG152	S68
21	43916118	44001550	ENSG00000160190.9	182	250	432	-0.457989644463	SG031	S95
13	43460524	43566385	ENSG00000133106.10	128	32	160	2.0	SG025	S34
19	17186591	17325346	ENSG00000099331.9	626	748	1374	-0.256875612955	SG002	S72
4	113195698	113207059	ENSG00000145365.10	222	154	376	0.527629325655	SG044	S86
11	576486	612222	ENSG00000070047.7	206	141	347	0.546949174784	SG043	S85
10	70847862	70864567	ENSG00000122862.4	695	557	1252	0.319335650271	SG021	S15
19	35759881	35770718	ENSG00000105698.11	444	350	794	0.34320475451800003	SG148	S94
5	96149731	96271097	ENSG00000247121.2	453	196	649	1.20865739593	SG043	S61
19	53097313	53193749	ENSG00000167766.14	37	97	134	-1.3904594765600002	SG037	S78
9	137533620	137736686	ENSG00000130635.11	419	26	445	4.01036671556	SG046	S57
17	38077294	38083854	ENSG00000172057.5	76	163	239	-1.10080064079	SG039	S51
3	121488610	121553926	ENSG00000173226.12	124	68	192	0.866733469137	SG031	S95
8	146015151	146017972	ENSG00000161016.11	2000	1702	3702	0.232768962976	SG039	S75
11	125440180	125462473	ENSG00000254671.1	19	55	74	-1.5334322000799998	SG021	S14
18	12991361	13125051	ENSG00000101639.14	103	171	274	-0.731351987703	SG040	S49
4	113195698	113207059	ENSG00000145365.10	212	129	341	0.7166931991399998	SG031	S46
1	16944751	16961054	ENSG00000215908.5	76	153	229	-1.00946032925	SG001	S1
1	111415775	111442550	ENSG00000143119.8	654	889	1543	-0.442892783332	SG026	S18
2	239008798	239041928	ENSG00000144488.10	40	9	49	2.15200309345	SG024	S13
21	45642874	45660849	ENSG00000160223.12	257	356	613	-0.470108881773	SG046	S81
5	177664619	178017556	ENSG00000050767.11	37	79	116	-1.09432738255	SG152	S70
6	116422012	116570660	ENSG00000178425.9	40	13	53	1.62148837675	SG026	S18
1	11994262	12035595	ENSG00000083444.12	147	85	232	0.790281408699	SG031	S46
1	111729796	111747157	ENSG00000162777.12	59	141	200	-1.25690830304	SG038	S53
22	44351301	44406411	ENSG00000100347.10	73	119	192	-0.704993204428	SG043	S85
18	34360019	34409068	ENSG00000134779.10	43	81	124	-0.913585248183	SG149	S66
19	35988122	36004560	ENSG00000161249.16	20	63	83	-1.65535182861	SG039	S74
7	141356611	141401953	ENSG00000257093.2	316	477	793	-0.5940647078279999	SG041	S59
19	10444452	10450499	ENSG00000076662.5	146	95	241	0.619968950549	SG043	S61
15	89179384	89199714	ENSG00000172183.10	239	339	578	-0.504274655156	SG069	S48
3	112640056	112693969	ENSG00000163606.6	10	37	47	-1.88752527074	SG045	S79
12	4361901	4384231	ENSG00000255920.1	117	176	293	-0.589066899054	SG040	S73
15	90773207	90776935	ENSG00000185043.6	113	43	156	1.39391420771	SG024	S36
5	95087023	95158709	ENSG00000173221.9	199	133	332	0.581342185042	SG027	S22
1	236681300	236716281	ENSG00000116977.14	396	520	916	-0.393011192949	SG045	S55
9	138898383	138987131	ENSG00000148411.3	20	1	21	4.3219280948900005	SG043	S85
6	89319985	89673348	ENSG00000111880.11	33	170	203	-2.36499681678	SG069	S47
20	37049235	37063996	ENSG00000196756.7	130	72	202	0.852442811586	SG030	S20
1	181143620	181151344	ENSG00000237292.1	2	23	25	-3.52356195606	SG030	S43
6	4115923	4135831	ENSG00000198721.8	63	121	184	-0.941583313775	SG041	S59
19	36525887	36545664	ENSG00000161277.9	19	3	22	2.66296501272	SG046	S81
3	194789008	194991896	ENSG00000173950.11	62	29	91	1.09621531526	SG069	S47
17	33800708	33864880	ENSG00000205045.4	39	95	134	-1.28445338947	SG155	S42
15	81451916	81601393	ENSG00000172349.12	88	145	233	-0.7204774713779999	SG042	S84
2	242673994	242708226	ENSG00000180902.12	335	164	499	1.03046528073	SG046	S81
3	150259781	150321015	ENSG00000120742.6	766	635	1401	0.270587800265	SG022	S12
22	22550113	22550860	ENSG00000211640.3	131	618	749	-2.23804002637	SG151	S88
9	130209953	130213684	ENSG00000197958.8	55	97	152	-0.818553128662	SG148	S94
6	25279306	25620758	ENSG00000079691.15	48	18	66	1.41503749928	SG069	S47
X	47431308	47479252	ENSG00000008056.8	51	137	188	-1.4256067409900002	SG040	S50
6	89319985	89673348	ENSG00000111880.11	248	103	351	1.2676957832	SG030	S21
15	86287340	86293512	ENSG00000259407.1	267	199	466	0.424071311144	SG152	S70
17	78109013	78120982	ENSG00000141543.5	192	132	324	0.540568381363	SG151	S65
4	76831809	76862102	ENSG00000138744.10	7	33	40	-2.2370391973	SG011	S32
7	142498725	142500432	ENSG00000211772.4	14	0	14	inf	SG037	S77
19	17186591	17325346	ENSG00000099331.9	764	636	1400	0.264545872751	SG044	S86
X	13707244	13728625	ENSG00000123595.5	0	12	12	-inf	SG152	S68
19	7112266	7294045	ENSG00000171105.9	130	62	192	1.06817150264	SG042	S60
7	1036622	1177896	ENSG00000146540.10	203	276	479	-0.443188539593	SG002	S7
6	42192669	42419789	ENSG00000124496.8	46	18	64	1.35363695461	SG022	S35
1	182350839	182361341	ENSG00000135821.12	138	88	226	0.6490928381409999	SG022	S35
10	97471536	97637023	ENSG00000138185.12	472	340	812	0.473252113224	SG043	S61
X	48433340	48437454	ENSG00000102317.13	6	416	422	-6.11547721742	SG152	S70
1	111415775	111442550	ENSG00000143119.8	882	1214	2096	-0.460917860698	SG152	S68
1	150702672	150738433	ENSG00000163131.6	84	144	228	-0.777607578664	SG026	S40
X	152599613	152625568	ENSG00000063587.12	215	6	221	5.16323034887	SG152	S68
12	109038885	109125372	ENSG00000110880.6	229	149	378	0.6200352676349999	SG069	S48
12	105380088	105443515	ENSG00000151131.5	82	140	222	-0.771731012327	SG031	S46
8	11413760	11415470	ENSG00000255518.1	158	106	264	0.575860293614	SG043	S62
17	48623667	48633213	ENSG00000006282.15	79	8	87	3.3037807481800003	SG024	S13
8	23154702	23282841	ENSG00000134013.11	30	4	34	2.90689059561	SG038	S52
12	120875893	120878545	ENSG00000111775.2	4	22	26	-2.45943161864	SG023	S16
12	104359582	104382652	ENSG00000139372.10	46	4	50	3.52356195606	SG037	S78
6	12514342	12515006	ENSG00000212802.3	0	74	74	-inf	SG006	S28
14	73704205	73741348	ENSG00000100767.11	11	0	11	inf	SG151	S64
14	100757448	100772884	ENSG00000197119.8	70	28	98	1.3219280948899998	SG031	S46
19	1009732	1021117	ENSG00000182087.8	452	620	1072	-0.455945442859	SG046	S80
4	5749811	5894785	ENSG00000072832.10	80	23	103	1.7983661388299998	SG041	S82
2	119981384	120023228	ENSG00000115107.15	37	11	48	1.75002174699	SG006	S4
1	183441351	183567381	ENSG00000116698.16	227	148	375	0.617095121662	SG023	S96
9	132649466	132805473	ENSG00000187239.12	369	214	583	0.7860100196590001	SG030	S43
20	4760669	4804291	ENSG00000101265.11	176	292	468	-0.7303929402429999	SG037	S54
22	22569184	22569660	ENSG00000211642.2	26	0	26	inf	SG148	S94
22	37309670	37336491	ENSG00000100368.9	8	61	69	-2.93073733756	SG041	S82
16	56965960	56977798	ENSG00000051108.10	138	198	336	-0.520832163301	SG040	S49
6	36644305	36655116	ENSG00000124762.9	847	666	1513	0.346839792261	SG043	S61
16	417384	420527	ENSG00000086504.11	120	61	181	0.976153258046	SG046	S57
20	62605466	62611361	ENSG00000130590.9	272	452	724	-0.7327161211650001	SG148	S94
14	76618259	76720685	ENSG00000089916.13	113	214	327	-0.921288023986	SG043	S62
2	233924677	234116549	ENSG00000168918.9	516	407	923	0.342342271157	SG148	S67
X	47431308	47479252	ENSG00000008056.8	41	94	135	-1.19703684706	SG007	S30
12	4361901	4384231	ENSG00000255920.1	95	178	273	-0.905877822635	SG043	S62
12	92536286	92539348	ENSG00000133639.3	93	206	299	-1.14734171608	SG007	S5
5	153708997	153825410	ENSG00000245275.3	44	96	140	-1.12553088208	SG150	S92
11	7448497	7533746	ENSG00000251364.2	14	54	68	-1.94753258011	SG006	S29
7	134853155	134854299	ENSG00000272941.1	91	50	141	0.863938450424	SG043	S85
3	40498783	40503861	ENSG00000188846.9	483	360	843	0.4240262825060001	SG042	S60
X	134382867	134478012	ENSG00000186376.10	2	26	28	-3.70043971814	SG031	S23
17	76104917	76106538	ENSG00000204282.3	27	6	33	2.16992500144	SG149	S66
18	32556892	32723434	ENSG00000166974.8	296	210	506	0.495207847963	SG149	S89
1	2488136	2496821	ENSG00000157873.13	665	544	1209	0.28974768913800003	SG152	S68
22	50354161	50357728	ENSG00000198355.4	1089	1297	2386	-0.252174525535	SG043	S61
19	7753644	7767032	ENSG00000104921.10	2648	1260	3908	1.07147938842	SG030	S21
4	68584714	68589980	ENSG00000270228.1	49	13	62	1.91427012597	SG152	S91
X	13752832	13787480	ENSG00000046651.10	7	53	60	-2.92056553251	SG152	S68
20	34894258	35157040	ENSG00000080845.13	57	107	164	-0.908576972236	SG046	S57
6	53132196	53213947	ENSG00000012660.9	44	81	125	-0.880418384247	SG043	S61
22	22550113	22550860	ENSG00000211640.3	11	100	111	-3.18442457114	SG027	S22
12	63359095	63359764	ENSG00000139239.6	18	0	18	inf	SG150	S93
6	167412670	167466201	ENSG00000213066.7	344	254	598	0.43758006793	SG151	S65
11	121322912	121504402	ENSG00000137642.8	360	496	856	-0.462343214057	SG022	S11
19	7459999	7537363	ENSG00000104880.13	150	217	367	-0.532732541949	SG152	S91
8	142136143	142140060	ENSG00000253210.1	7	27	34	-1.94753258011	SG152	S70
11	289138	296107	ENSG00000142102.11	225	96	321	1.2288186905	SG155	S19
14	94843084	94857030	ENSG00000197249.8	0	11	11	-inf	SG069	S48
7	56078744	56119297	ENSG00000146733.9	107	1	108	6.7414669864	SG030	S43
3	122296449	122357894	ENSG00000173200.8	41	84	125	-1.03476541816	SG148	S67
6	43968317	43973695	ENSG00000181577.11	97	51	148	0.927487500216	SG041	S59
22	22657589	22664766	ENSG00000272779.1	24	66	90	-1.4594316186399998	SG155	S19
20	61640735	61716423	ENSG00000272259.1	161	396	557	-1.29843974196	SG150	S69
16	84211525	84220669	ENSG00000103168.12	311	184	495	0.757208814074	SG039	S51
17	3413796	3461289	ENSG00000167723.10	30	85	115	-1.50250034053	SG031	S46
X	9983602	10112518	ENSG00000047644.13	0	16	16	-inf	SG152	S70
2	219081817	219119079	ENSG00000163466.11	93	33	126	1.4947646917500002	SG011	S32
15	22892005	23004683	ENSG00000068793.13	35	75	110	-1.09953567355	SG152	S70
X	153625495	153632038	ENSG00000147403.12	57	4	61	3.83289001416	SG046	S57
1	62660503	62678000	ENSG00000240563.1	0	12	12	-inf	SG023	S16
3	142720310	142779567	ENSG00000163714.13	43	14	57	1.61890983264	SG045	S55
2	26413504	26467594	ENSG00000084754.6	250	337	587	-0.4308204965199999	SG021	S15
22	47080308	47134158	ENSG00000100422.9	29	73	102	-1.33184356375	SG002	S72
19	16177831	16213813	ENSG00000167460.10	356	158	514	1.17195268279	SG149	S90
11	102391239	102401484	ENSG00000137673.4	86	27	113	1.67137725254	SG042	S84
22	50713408	50746056	ENSG00000196576.10	136	198	334	-0.541893778829	SG001	S1
1	101788893	101855859	ENSG00000231671.1	122	12	134	3.34577483684	SG038	S52
8	144349603	144359101	ENSG00000250571.2	61	109	170	-0.8374469872139999	SG148	S94
10	105148823	105156223	ENSG00000173915.8	9	43	52	-2.25633975326	SG031	S23
17	3511556	3539616	ENSG00000197417.7	60	28	88	1.09953567355	SG155	S19
3	186648274	186796341	ENSG00000073849.10	769	1083	1852	-0.493977739647	SG001	S26
22	17517460	17541715	ENSG00000237438.2	69	244	313	-1.82221288078	SG148	S71
1	101788893	101855859	ENSG00000231671.1	2	83	85	-5.37503943135	SG150	S69
17	16342136	16381992	ENSG00000175061.13	488	695	1183	-0.510131830048	SG038	S52
6	38683117	38998301	ENSG00000124721.13	30	8	38	1.90689059561	SG022	S11
16	420773	434396	ENSG00000129925.6	187	125	312	0.5811101752260001	SG038	S76
19	49990811	49995565	ENSG00000142541.12	2111	2822	4933	-0.41879140925	SG045	S56
2	75061115	75120486	ENSG00000159399.5	118	69	187	0.774118592584	SG043	S85
17	3575493	3599698	ENSG00000083454.17	318	993	1311	-1.64276695224	SG044	S63
12	108681821	108733118	ENSG00000174600.9	9	38	47	-2.078002512	SG023	S16
17	49242796	49249108	ENSG00000243678.7	225	325	550	-0.530514716699	SG006	S29
2	54683422	54896812	ENSG00000115306.11	316	232	548	0.44579975305	SG003	S27
10	75757872	75879918	ENSG00000035403.12	105	51	156	1.04182017569	SG148	S71
3	156257929	156272973	ENSG00000114850.2	482	639	1121	-0.406782784717	SG027	S22
8	103540968	103550896	ENSG00000253633.1	6	46	52	-2.9385994553400003	SG026	S17
X	152710178	152736045	ENSG00000183479.8	34	3	37	3.50250034053	SG022	S12
19	54024235	54083523	ENSG00000130844.12	8	33	41	-2.04439411936	SG149	S90
6	33738979	33756913	ENSG00000161904.7	174	115	289	0.597453444904	SG030	S20
17	49242796	49249108	ENSG00000243678.7	432	328	760	0.397335497545	SG043	S85
11	71164155	71235153	ENSG00000172890.7	168	108	276	0.637429920615	SG152	S68
13	110958159	111165374	ENSG00000134871.13	61	27	88	1.1758498354	SG155	S19
X	53559057	53713673	ENSG00000086758.11	39	5	44	2.96347412397	SG046	S81
5	169291268	169407744	ENSG00000204767.3	3	29	32	-3.27301849441	SG003	S27
19	14844559	14889353	ENSG00000127507.13	9	34	43	-1.91753783981	SG001	S25
1	169631245	169823221	ENSG00000000460.12	459	199	658	1.20572572287	SG003	S27
15	90773207	90776935	ENSG00000185043.6	92	33	125	1.4791678366999998	SG041	S82
11	77779398	77791265	ENSG00000151366.8	47	107	154	-1.18687813472	SG152	S70
1	220921567	220958150	ENSG00000117791.11	43	0	43	inf	SG152	S70
2	114647537	114720173	ENSG00000115091.7	321	224	545	0.5190745650649999	SG027	S45
20	61509090	61569304	ENSG00000101191.12	144	92	236	0.646363045385	SG001	S1
8	11415975	11417529	ENSG00000255354.1	132	48	180	1.4594316186399998	SG148	S67
9	19375995	19380252	ENSG00000137154.8	45	104	149	-1.20858662181	SG045	S56
19	1026298	1039068	ENSG00000064666.10	1735	1511	3246	0.199432002301	SG039	S51
12	130880682	131002462	ENSG00000060709.9	0	12	12	-inf	SG031	S46
11	289138	296107	ENSG00000142102.11	212	488	700	-1.202816883	SG151	S64
16	19714902	19729016	ENSG00000103550.9	4	45	49	-3.4918530963300003	SG150	S92
6	129897277	130031370	ENSG00000146376.6	22	57	79	-1.37345839553	SG003	S3
1	160510885	160549306	ENSG00000066294.10	78	134	212	-0.7806869715960001	SG155	S42
7	134777115	134855547	ENSG00000122783.12	277	407	684	-0.555142818217	SG155	S41
6	169857307	170102159	ENSG00000184465.11	172	104	276	0.7258250365610001	SG041	S58
16	3493611	3536963	ENSG00000122390.13	249	160	409	0.638073837181	SG046	S81
5	96149731	96271097	ENSG00000247121.2	616	139	755	2.1478454679700003	SG023	S39
19	7753644	7767032	ENSG00000104921.10	1432	2518	3950	-0.8142467904549999	SG040	S50
7	64126511	64171404	ENSG00000196247.7	81	34	115	1.25238716163	SG037	S54
3	16355081	16555533	ENSG00000131378.9	189	310	499	-0.7138819810529999	SG155	S19
1	26856252	26901521	ENSG00000117676.9	211	146	357	0.531274629827	SG150	S93
3	196673214	196695742	ENSG00000119227.3	28	62	90	-1.14684138833	SG038	S52
19	18283972	18288927	ENSG00000216490.3	734	878	1612	-0.258440876692	SG007	S5
2	177134123	177202753	ENSG00000128654.9	84	45	129	0.900464326449	SG022	S35
3	12328867	12475855	ENSG00000132170.15	5	24	29	-2.26303440583	SG002	S31
2	239008798	239041928	ENSG00000144488.10	41	11	52	1.89812038598	SG024	S36
16	2867164	2876305	ENSG00000007038.6	7	29	36	-2.05062607307	SG151	S88
10	101635334	101769676	ENSG00000107554.11	94	50	144	0.910732661903	SG022	S11
16	1845621	1876967	ENSG00000063854.8	21	50	71	-1.251538767	SG001	S25
15	34671272	34880704	ENSG00000175265.13	60	109	169	-0.8612937291680001	SG024	S36
1	7844380	7905237	ENSG00000049246.10	28	3	31	3.22239242134	SG039	S74
22	43547520	43559248	ENSG00000100300.13	109	171	280	-0.649668190109	SG030	S20
19	47104493	47114050	ENSG00000160014.12	1029	1250	2279	-0.280685112655	SG001	S1
19	617223	633597	ENSG00000099821.9	18	49	67	-1.4447848426700003	SG046	S81
16	3415099	3536960	ENSG00000262621.2	180	106	286	0.763932641766	SG150	S93
11	102391239	102401484	ENSG00000137673.4	9	40	49	-2.15200309345	SG037	S54
6	57179603	57513375	ENSG00000146143.13	37	8	45	2.20945336563	SG039	S51
22	23198937	23199213	ENSG00000253234.1	20	2	22	3.32192809489	SG030	S43
1	182992595	183114727	ENSG00000135862.5	177	290	467	-0.712303539932	SG152	S70
17	45900638	45908900	ENSG00000159111.8	207	142	349	0.543739837995	SG148	S71
12	109038885	109125372	ENSG00000110880.6	140	202	342	-0.528928465807	SG152	S68
1	6051526	6161253	ENSG00000069424.10	548	753	1301	-0.458473971711	SG043	S62
2	231729354	231743963	ENSG00000135916.11	289	159	448	0.862042727216	SG155	S42
2	231068340	231177930	ENSG00000079263.14	48	115	163	-1.2605275502200002	SG148	S94
2	64370373	64479993	ENSG00000225889.3	71	157	228	-1.14487362939	SG024	S36
19	49375649	49379314	ENSG00000087074.7	217	135	352	0.684735635394	SG031	S95
7	43648055	43769316	ENSG00000106603.13	258	341	599	-0.402400673601	SG069	S47
12	92378756	92535489	ENSG00000257242.2	33	8	41	2.04439411936	SG030	S43
19	18682540	18688360	ENSG00000221983.3	765	559	1324	0.452611464737	SG040	S73
11	118868852	118886421	ENSG00000186166.4	41	16	57	1.35755200462	SG038	S52
16	475619	573011	ENSG00000090565.11	0	35	35	-inf	SG031	S46
6	154475631	154677926	ENSG00000074706.9	167	108	275	0.628816790311	SG022	S12
8	29190581	29208185	ENSG00000120875.4	1144	851	1995	0.426856015092	SG043	S85
2	89291928	89292450	ENSG00000240671.1	12	78	90	-2.70043971814	SG027	S45
22	22569184	22569660	ENSG00000211642.2	49	1	50	5.614709844119999	SG040	S49
12	113344582	113369990	ENSG00000089127.8	483	795	1278	-0.718931671336	SG041	S82
18	61570135	61603345	ENSG00000242550.1	19	110	129	-2.53343220008	SG039	S51
14	77893018	77924212	ENSG00000151445.11	10	33	43	-1.72246602447	SG069	S48
5	179261436	179285887	ENSG00000161010.10	162	337	499	-1.0567547783	SG043	S61
14	106494135	106494597	ENSG00000211937.2	114	21	135	2.4405725913900005	SG031	S23
7	142498725	142500432	ENSG00000211772.4	13	0	13	inf	SG039	S51
6	144261437	144385735	ENSG00000118495.14	38	76	114	-1.0	SG024	S36
3	195754054	195809060	ENSG00000072274.8	1100	916	2016	0.264084020315	SG150	S69
1	161552880	161575452	ENSG00000244682.3	1	46	47	-5.523561956059999	SG042	S84
10	75008621	75012451	ENSG00000182180.9	106	52	158	1.02748073642	SG041	S58
6	130334844	130462594	ENSG00000198945.3	26	5	31	2.37851162325	SG037	S77
19	47759237	47775210	ENSG00000105321.8	84	152	236	-0.8556100906649999	SG003	S27
8	98285717	98290176	ENSG00000180543.3	18	0	18	inf	SG043	S62
17	37026112	37078023	ENSG00000002834.13	327	242	569	0.434283588223	SG007	S5
4	5749811	5894785	ENSG00000072832.10	37	11	48	1.75002174699	SG045	S56
5	6714718	6757161	ENSG00000112941.8	230	429	659	-0.8993437865549999	SG152	S70
1	1634169	1655766	ENSG00000008128.18	36	135	171	-1.90689059561	SG149	S66
7	1036622	1177896	ENSG00000146540.10	927	1142	2069	-0.300921406737	SG025	S34
3	42642106	42690227	ENSG00000114857.13	230	164	394	0.487938046326	SG150	S69
7	44143960	44154161	ENSG00000106624.4	19	1	20	4.2479275134400005	SG001	S25
19	46969748	46974820	ENSG00000182013.13	18	0	18	inf	SG023	S39
1	65613232	65697828	ENSG00000162433.10	61	29	90	1.07275634244	SG002	S7
X	19552093	19905719	ENSG00000147010.13	143	61	204	1.22913399922	SG031	S23
5	27472399	27496508	ENSG00000250337.1	25	6	31	2.05889368905	SG155	S41
5	177019159	177023125	ENSG00000184840.7	205	322	527	-0.651436778609	SG027	S44
11	68914696	68939032	ENSG00000261070.1	51	92	143	-0.851136614086	SG041	S82
10	34398488	35104253	ENSG00000148498.11	17	53	70	-1.64045761331	SG025	S34
21	46305868	46351904	ENSG00000160255.12	341	536	877	-0.652461261434	SG037	S54
5	175810949	175815976	ENSG00000048162.15	158	281	439	-0.830645572044	SG046	S80
8	11415975	11417529	ENSG00000255354.1	65	116	181	-0.835613182099	SG149	S90
16	11343506	11445619	ENSG00000175643.7	185	94	279	0.976792608839	SG001	S1
12	7022909	7032861	ENSG00000111674.4	235	153	388	0.6191291038719999	SG024	S13
17	17115526	17140496	ENSG00000154803.8	31	64	95	-1.04580368961	SG021	S38
14	58731380	58736399	ENSG00000258682.1	20	52	72	-1.37851162325	SG023	S96
9	6716548	6727438	ENSG00000225489.2	48	3	51	4.0	SG002	S31
1	31205316	31230667	ENSG00000162511.7	924	1102	2026	-0.254159467155	SG069	S48
9	132649466	132805473	ENSG00000187239.12	368	226	594	0.703382993642	SG039	S75
X	118892576	118894164	ENSG00000187808.3	3	22	25	-2.87446911792	SG046	S80
14	35870717	35873952	ENSG00000100906.6	657	510	1167	0.365396123463	SG039	S74
21	46352729	46359828	ENSG00000183250.7	84	153	237	-0.865070419914	SG041	S58
1	181382238	181777219	ENSG00000198216.6	54	13	67	2.05444778402	SG155	S42
2	131113580	131132982	ENSG00000072135.8	289	206	495	0.488425155317	SG024	S36
20	42295754	42345136	ENSG00000101057.11	131	53	184	1.30550254697	SG069	S24
8	144656966	144660783	ENSG00000147813.11	7	84	91	-3.58496250072	SG001	S26
21	42792231	42831141	ENSG00000157601.9	1168	1340	2508	-0.198192726465	SG069	S48
6	111303218	111349466	ENSG00000197498.8	5	25	30	-2.32192809489	SG025	S34
3	196673214	196695742	ENSG00000119227.3	47	92	139	-0.968973104379	SG027	S45
3	16355081	16555533	ENSG00000131378.9	502	395	897	0.34583471088600004	SG021	S14
18	9708162	9862548	ENSG00000168461.8	21	138	159	-2.716207034	SG002	S72
8	8993765	9009084	ENSG00000173281.4	82	43	125	0.931287249916	SG025	S33
15	70340129	70390515	ENSG00000140332.11	335	252	587	0.410737361845	SG041	S59
X	118920467	118925606	ENSG00000198918.7	27	3	30	3.16992500144	SG031	S95
1	9095166	9148537	ENSG00000142583.13	189	114	303	0.729352410056	SG040	S50
7	142498725	142500432	ENSG00000211772.4	25	63	88	-1.33342373373	SG150	S92
1	85391268	85462796	ENSG00000153898.8	595	386	981	0.624288820927	SG152	S70
4	119199864	119200978	ENSG00000269893.2	181	116	297	0.641864891956	SG002	S72
16	58741035	58768261	ENSG00000125166.8	152	227	379	-0.578620973847	SG023	S16
3	150126122	150184218	ENSG00000196428.8	10	35	45	-1.80735492206	SG148	S67
9	2621834	2660053	ENSG00000147852.11	4	21	25	-2.39231742278	SG043	S85
12	113345433	113455556	ENSG00000257452.1	3032	2772	5804	0.129342496034	SG039	S51
5	81267844	81572676	ENSG00000152348.11	131	63	194	1.0561430780399998	SG003	S2
11	60897728	60929089	ENSG00000167987.6	54	24	78	1.16992500144	SG027	S45
17	16945859	17120993	ENSG00000133030.15	219	302	521	-0.463617679724	SG044	S87
15	80253231	80263788	ENSG00000140379.7	450	564	1014	-0.32577016118200003	SG152	S68
1	220863187	220872499	ENSG00000162817.6	39	0	39	inf	SG152	S70
17	48623667	48633213	ENSG00000006282.15	30	127	157	-2.08179409116	SG002	S72
1	146714291	146767443	ENSG00000131778.13	109	170	279	-0.641206611361	SG043	S62
7	56078744	56119297	ENSG00000146733.9	77	5	82	3.94485844581	SG069	S47
2	182321934	182400914	ENSG00000115232.9	153	251	404	-0.714155711258	SG151	S65
5	96149731	96271097	ENSG00000247121.2	245	68	313	1.84917509775	SG031	S95
6	3020388	3022984	ENSG00000270346.1	2	19	21	-3.2479275134400005	SG003	S3
20	16252749	16554078	ENSG00000089177.13	1	13	14	-3.70043971814	SG043	S61
8	145153536	145162961	ENSG00000179526.12	159	225	384	-0.500898235933	SG038	S53
10	105148823	105156223	ENSG00000173915.8	2	27	29	-3.75488750216	SG021	S38
20	43514317	43537173	ENSG00000166913.8	461	337	798	0.452018159247	SG003	S2
16	70190243	70207224	ENSG00000247228.2	126	238	364	-0.917537839808	SG044	S86
8	11351510	11422113	ENSG00000136573.8	331	447	778	-0.433443614376	SG044	S86
13	111267881	111291674	ENSG00000213995.7	202	123	325	0.715696977413	SG045	S56
X	68380694	68385636	ENSG00000181191.11	9	45	54	-2.32192809489	SG031	S46
6	89319985	89673348	ENSG00000111880.11	37	117	154	-1.66091135395	SG069	S48
21	47608055	47648738	ENSG00000160285.10	188	92	280	1.0310268956200002	SG021	S38
15	34671272	34880704	ENSG00000175265.13	158	237	395	-0.584962500721	SG039	S74
3	39371197	39375171	ENSG00000179934.5	2	19	21	-3.2479275134400005	SG030	S21
2	29005383	29073477	ENSG00000163806.11	94	43	137	1.12832409698	SG040	S50
X	2822011	2847392	ENSG00000006756.11	14	0	14	inf	SG022	S35
14	107113741	107114274	ENSG00000223648.2	19	0	19	inf	SG027	S44
7	134777115	134855547	ENSG00000122783.12	344	263	607	0.38734576541	SG003	S3
19	4838423	4867780	ENSG00000105355.4	14	161	175	-3.52356195606	SG043	S61
22	43547520	43559248	ENSG00000100300.13	63	19	82	1.7293524100599995	SG011	S9
11	67351066	67354131	ENSG00000084207.11	1050	1250	2300	-0.251538766996	SG069	S47
22	42069934	42086508	ENSG00000100138.9	186	126	312	0.561878887608	SG001	S1
10	75757872	75879918	ENSG00000035403.12	28	83	111	-1.5676845092899998	SG150	S69
7	149570057	149577784	ENSG00000171130.13	84	141	225	-0.74723392962	SG007	S30
6	11712287	11807279	ENSG00000111863.8	56	23	79	1.283792966	SG031	S95
13	24995064	25086948	ENSG00000102699.5	154	217	371	-0.49476469175	SG152	S68
20	62612488	62664453	ENSG00000101161.6	277	446	723	-0.687157733871	SG042	S84
17	3575493	3599698	ENSG00000083454.17	312	83	395	1.91036278752	SG026	S17
16	75661622	75681577	ENSG00000065427.10	80	140	220	-0.807354922058	SG150	S93
7	151038785	151075535	ENSG00000013374.11	223	150	373	0.572081209424	SG025	S34
3	98239976	98312567	ENSG00000080819.2	501	616	1117	-0.2981197475	SG024	S36
11	93211638	93276674	ENSG00000166002.2	26	74	100	-1.5090136474899998	SG031	S95
12	9868456	9885895	ENSG00000184293.3	34	75	109	-1.14135584925	SG041	S59
X	12993227	12995346	ENSG00000205542.6	2829	2154	4983	0.393273926852	SG003	S27
1	169659808	169680839	ENSG00000188404.4	155	86	241	0.849859650572	SG155	S19
2	65215611	65250999	ENSG00000115902.6	267	192	459	0.475733430966	SG002	S31
14	24422795	24438488	ENSG00000157326.14	43	14	57	1.61890983264	SG006	S28
22	43254393	43411151	ENSG00000100266.13	285	185	470	0.623436648536	SG022	S11
11	2316875	2324279	ENSG00000110665.7	2	19	21	-3.2479275134400005	SG011	S8
12	113416200	113449528	ENSG00000111335.8	217	308	525	-0.5052353082500001	SG023	S39
1	243651535	244014381	ENSG00000117020.12	16	45	61	-1.49185309633	SG043	S61
7	64139332	64147771	ENSG00000271550.1	65	15	80	2.11547721742	SG027	S44
6	53132196	53213947	ENSG00000012660.9	78	36	114	1.11547721742	SG041	S59
1	40157854	40229586	ENSG00000084072.12	34	82	116	-1.2700891633700002	SG002	S31
17	38375556	38440388	ENSG00000171475.9	3	28	31	-3.22239242134	SG150	S93
6	3849620	3851551	ENSG00000145945.5	0	15	15	-inf	SG002	S31
11	128328656	128457453	ENSG00000134954.10	84	137	221	-0.7057146601819999	SG148	S94
7	64139332	64147771	ENSG00000271550.1	49	21	70	1.22239242134	SG042	S60
X	153991031	154005964	ENSG00000130826.11	116	25	141	2.21412480535	SG031	S95
1	110210644	110252171	ENSG00000213366.8	60	20	80	1.58496250072	SG021	S14
7	1036622	1177896	ENSG00000146540.10	658	480	1138	0.455053178127	SG069	S47
1	203274619	203278730	ENSG00000159388.5	125	66	191	0.921390165304	SG037	S54
1	100731763	100758325	ENSG00000137996.8	18	46	64	-1.35363695461	SG023	S96
2	242576865	242613272	ENSG00000168397.12	207	140	347	0.564203940554	SG031	S23
19	18169805	18209754	ENSG00000096996.11	128	234	362	-0.870364719583	SG006	S29
11	125439112	125454575	ENSG00000149547.10	11	58	69	-2.39854937649	SG002	S31
X	40944888	41095832	ENSG00000124486.8	46	11	57	2.06413033742	SG069	S24
4	10488019	10686489	ENSG00000109684.10	82	27	109	1.60266450245	SG040	S73
19	57285920	57352097	ENSG00000269699.1	0	22	22	-inf	SG046	S57
11	64107695	64125006	ENSG00000168071.17	306	396	702	-0.371968777387	SG001	S25
2	191273081	191367041	ENSG00000151690.10	32	68	100	-1.08746284125	SG024	S36
1	40538379	40563375	ENSG00000131238.12	197	134	331	0.555962628999	SG003	S2
2	105654441	105716418	ENSG00000135972.4	134	211	345	-0.655009998249	SG024	S37
1	169659808	169680839	ENSG00000188404.4	403	156	559	1.36923380967	SG001	S1
22	19929130	19957418	ENSG00000093010.7	394	256	650	0.6220518194560001	SG149	S90
7	134853155	134854299	ENSG00000272941.1	93	45	138	1.0473057147799998	SG043	S62
19	2252251	2269758	ENSG00000167476.6	16	1	17	4.0	SG045	S79
11	62619460	62623386	ENSG00000255717.2	87	148	235	-0.76650986978	SG006	S29
22	23010758	23011276	ENSG00000211658.2	16	0	16	inf	SG003	S2
20	34213953	34252878	ENSG00000214078.7	161	358	519	-1.15289889915	SG038	S53
4	185616118	185655287	ENSG00000151725.7	25	57	82	-1.18903382439	SG031	S46
X	152599613	152625568	ENSG00000063587.12	220	44	264	2.32192809489	SG069	S48
18	12991361	13125051	ENSG00000101639.14	151	84	235	0.8460873165459999	SG001	S26
4	186320694	186347139	ENSG00000109775.6	33	66	99	-1.0	SG148	S71
19	7701877	7712759	ENSG00000076944.10	178	254	432	-0.512951255806	SG043	S62
2	105713510	105719402	ENSG00000231851.1	130	81	211	0.682517810144	SG025	S10
14	50085237	50087403	ENSG00000165502.6	5	28	33	-2.48542682717	SG002	S72
14	105391153	105399574	ENSG00000166428.8	15	45	60	-1.58496250072	SG046	S81
1	161551101	161648444	ENSG00000072694.14	25	116	141	-2.21412480535	SG042	S60
3	100211463	100296288	ENSG00000181458.6	0	19	19	-inf	SG022	S35
3	45016733	45054160	ENSG00000075914.8	74	39	113	0.924051146767	SG152	S91
6	6144318	6321246	ENSG00000124491.11	4	22	26	-2.45943161864	SG039	S75
2	242673994	242708226	ENSG00000180902.12	105	201	306	-0.936806173513	SG069	S48
6	169857307	170102159	ENSG00000184465.11	128	78	206	0.714597781138	SG041	S82
1	85391268	85462796	ENSG00000153898.8	560	1145	1705	-1.03184886604	SG150	S69
4	119199864	119200978	ENSG00000269893.2	232	156	388	0.572578776265	SG044	S87
1	39997510	40024379	ENSG00000243970.1	4	24	28	-2.58496250072	SG046	S80
X	119561682	119603220	ENSG00000005893.11	46	120	166	-1.3833286395500002	SG007	S5
4	1723227	1746898	ENSG00000013810.14	293	401	694	-0.452701572033	SG044	S63
10	45950035	46090354	ENSG00000165406.11	189	263	452	-0.476676565071	SG025	S10
12	92860227	92885867	ENSG00000205056.8	25	57	82	-1.18903382439	SG002	S72
10	5807186	5884095	ENSG00000057608.12	354	454	808	-0.358942937208	SG007	S6
17	79617489	79630142	ENSG00000185527.7	37	76	113	-1.03847414781	SG038	S53
17	40610862	40674629	ENSG00000033627.10	96	44	140	1.12553088208	SG043	S61
14	105952654	105955284	ENSG00000213145.5	527	806	1333	-0.612976876891	SG031	S95
19	17525157	17533133	ENSG00000269481.1	132	82	214	0.6868421147399999	SG024	S36
X	122993574	123047829	ENSG00000101966.8	9	81	90	-3.16992500144	SG022	S35
3	122399465	122449687	ENSG00000173193.9	232	154	386	0.591194454433	SG003	S3
22	43562628	43583139	ENSG00000100304.12	79	131	210	-0.7296422533600001	SG023	S39
16	31711911	31721097	ENSG00000131797.8	103	57	160	0.853610513018	SG022	S11
14	107178820	107179338	ENSG00000211974.2	145	3	148	5.59494658929	SG001	S1
X	131503345	131623996	ENSG00000076770.10	2	18	20	-3.16992500144	SG022	S11
15	50647606	50659636	ENSG00000244879.3	45	110	155	-1.28950661719	SG044	S63
7	64139332	64147771	ENSG00000271550.1	55	13	68	2.08091999538	SG043	S62
17	7743222	7758114	ENSG00000132510.6	61	130	191	-1.09163047547	SG152	S91
14	24678789	24683075	ENSG00000254505.4	60	106	166	-0.821029858955	SG006	S28
12	133264192	133294706	ENSG00000176894.5	28	68	96	-1.28010791919	SG043	S85
19	19010323	19030206	ENSG00000105669.8	36	11	47	1.7104933828100002	SG148	S71
11	58976061	58980424	ENSG00000197629.5	14	43	57	-1.61890983264	SG030	S21
19	6887577	6940470	ENSG00000174837.10	23	1	24	4.52356195606	SG024	S13
1	182350839	182361341	ENSG00000135821.12	5	26	31	-2.37851162325	SG044	S86
8	98787285	98865241	ENSG00000104341.12	8	30	38	-1.90689059561	SG022	S35
19	35810164	35838258	ENSG00000012124.10	344	478	822	-0.474602053279	SG026	S17
19	51300961	51308186	ENSG00000167747.9	813	673	1486	0.272648847465	SG001	S26
6	16129356	16148479	ENSG00000007944.10	109	183	292	-0.7475155135070001	SG148	S94
4	8183799	8243530	ENSG00000125089.12	86	170	256	-0.983126181436	SG150	S93
2	219135115	219211516	ENSG00000127838.9	102	44	146	1.21299372333	SG024	S13
19	49990811	49995565	ENSG00000142541.12	2833	2025	4858	0.484408693719	SG044	S63
15	75182346	75191798	ENSG00000178802.13	159	98	257	0.6981731111689999	SG025	S34
6	167342992	167370672	ENSG00000026297.11	444	349	793	0.34733264014	SG001	S25
11	33880122	33913836	ENSG00000135363.7	70	168	238	-1.2630344058299998	SG152	S68
3	127783621	127872757	ENSG00000175792.7	1037	877	1914	0.241767146368	SG006	S29
12	25173936	25261268	ENSG00000118308.10	266	384	650	-0.52968006522	SG023	S96
X	131352535	131566890	ENSG00000232160.2	0	14	14	-inf	SG022	S35
19	47759237	47775210	ENSG00000105321.8	54	105	159	-0.959358015503	SG001	S26
6	37600284	37667082	ENSG00000112139.10	52	2	54	4.70043971814	SG001	S25
5	153570290	153800544	ENSG00000164574.11	98	56	154	0.807354922058	SG046	S81
11	76368100	76374910	ENSG00000236304.1	49	114	163	-1.21818017005	SG043	S61
1	16944751	16961054	ENSG00000215908.5	68	26	94	1.38702312311	SG045	S55
10	105148823	105156223	ENSG00000173915.8	22	55	77	-1.3219280948899998	SG069	S47
12	49208215	49222724	ENSG00000167535.3	21	2	23	3.39231742278	SG069	S48
7	134777115	134855547	ENSG00000122783.12	298	413	711	-0.470829450957	SG039	S75
2	241938255	242034011	ENSG00000162804.9	108	175	283	-0.6963236096690001	SG024	S36
7	30555925	30625588	ENSG00000196295.7	83	140	223	-0.754243585598	SG006	S4
17	36891298	36904631	ENSG00000056661.9	15	81	96	-2.43295940728	SG045	S55
11	167784	207428	ENSG00000177951.13	174	245	419	-0.493694443154	SG042	S84
22	23222886	23223576	ENSG00000211673.2	151	57	208	1.40551472516	SG037	S77
11	67351066	67354131	ENSG00000084207.11	1227	1018	2245	0.269397687587	SG030	S21
12	10524952	10544473	ENSG00000213809.4	29	7	36	2.05062607307	SG021	S14
1	110210644	110252171	ENSG00000213366.8	37	5	42	2.88752527074	SG002	S72
11	68816365	68858072	ENSG00000162341.11	80	137	217	-0.776103988073	SG149	S89
X	122993574	123047829	ENSG00000101966.8	54	7	61	2.94753258011	SG031	S46
2	239008798	239041928	ENSG00000144488.10	14	85	99	-2.60203601408	SG044	S63
17	38175350	38217468	ENSG00000008838.13	83	137	220	-0.7229926516140001	SG148	S67
22	51007290	51017096	ENSG00000205560.8	32	68	100	-1.08746284125	SG002	S72
19	35810164	35838258	ENSG00000012124.10	47	20	67	1.23266075679	SG041	S59
22	24236770	24241117	ENSG00000218537.1	37	9	46	2.03952836419	SG002	S31
11	43577986	43878160	ENSG00000149084.7	98	169	267	-0.786169592167	SG151	S64
11	62619460	62623386	ENSG00000255717.2	153	95	248	0.687532234362	SG027	S44
6	86370710	86388451	ENSG00000203875.6	707	137	844	2.36753432185	SG003	S27
17	40701232	40707231	ENSG00000108786.6	26	6	32	2.11547721742	SG149	S89
22	42262835	42303312	ENSG00000198911.7	175	53	228	1.72329065727	SG040	S50
9	98521513	98637982	ENSG00000175611.7	18	1	19	4.16992500144	SG023	S96
2	68592305	68624585	ENSG00000115956.9	2149	2783	4932	-0.372975425904	SG039	S74
22	23029190	23029735	ENSG00000211659.2	15	0	15	inf	SG152	S91
X	73049067	73072588	ENSG00000229807.5	61	106	167	-0.797183117	SG148	S67
19	18682540	18688360	ENSG00000221983.3	721	512	1233	0.493855449241	SG030	S43
11	122928197	122933938	ENSG00000109971.9	925	1211	2136	-0.388673594291	SG044	S63
6	391739	411447	ENSG00000137265.10	1200	1408	2608	-0.230612928141	SG001	S25
1	19923477	19956314	ENSG00000173436.9	75	126	201	-0.748461233004	SG038	S53
6	6346698	6623004	ENSG00000216863.5	47	18	65	1.38466385024	SG007	S30
14	106383838	106391825	ENSG00000226777.3	438	75	513	2.54596836911	SG027	S22
6	160210844	160219468	ENSG00000112110.5	117	71	188	0.720617600079	SG043	S61
16	12070594	12668146	ENSG00000048471.9	607	444	1051	0.451136839906	SG031	S23
14	73393040	73426411	ENSG00000119599.12	16	46	62	-1.52356195606	SG021	S15
22	39745930	39781593	ENSG00000100321.10	5	76	81	-3.92599941856	SG148	S71
6	160390131	160534539	ENSG00000197081.8	180	122	302	0.561115758767	SG030	S20
17	3413796	3461289	ENSG00000167723.10	8	64	72	-3.0	SG040	S49
X	152599613	152625568	ENSG00000063587.12	181	6	187	4.91488338636	SG152	S91
6	166719168	166721936	ENSG00000176381.4	32	10	42	1.6780719051100002	SG046	S81
9	137533620	137736686	ENSG00000130635.11	122	191	313	-0.646691490473	SG027	S22
5	96149731	96271097	ENSG00000247121.2	129	513	642	-1.99158776018	SG030	S21
1	231499497	231560790	ENSG00000135766.8	6	28	34	-2.22239242134	SG155	S41
1	28566020	28567964	ENSG00000270605.1	13	38	51	-1.5474877953	SG025	S10
10	75008621	75012451	ENSG00000182180.9	98	57	155	0.7818198299500001	SG042	S84
2	113969099	114034158	ENSG00000189223.9	82	0	82	inf	SG044	S87
17	46970127	46973233	ENSG00000159199.9	77	38	115	1.01885902725	SG006	S28
14	93170152	93215047	ENSG00000100600.10	365	274	639	0.413720570807	SG037	S77
X	21857754	21903542	ENSG00000012174.7	44	8	52	2.45943161864	SG003	S3
21	46352729	46359828	ENSG00000183250.7	103	59	162	0.803857477821	SG003	S3
5	179224597	179233934	ENSG00000161013.12	78	148	226	-0.924051146767	SG046	S80
11	60223225	60238233	ENSG00000156738.13	1187	1385	2572	-0.222566041295	SG040	S49
3	81538850	81811312	ENSG00000114480.8	150	231	381	-0.62293035092	SG045	S56
18	672546	712676	ENSG00000132199.14	717	581	1298	0.303434955297	SG024	S13
13	50202435	50208008	ENSG00000152213.3	5	27	32	-2.43295940728	SG155	S42
1	110210644	110252171	ENSG00000213366.8	15	71	86	-2.2428565239	SG041	S82
19	3630181	3700477	ENSG00000186111.4	146	43	189	1.7635598041799998	SG003	S2
3	52870235	52931612	ENSG00000213533.7	65	28	93	1.21501289097	SG023	S39
8	74851404	74884522	ENSG00000154582.12	10	36	46	-1.84799690655	SG021	S38
17	289769	295730	ENSG00000183688.4	117	39	156	1.58496250072	SG069	S48
7	130561495	130598069	ENSG00000226380.3	5	30	35	-2.58496250072	SG155	S42
16	2961938	3001209	ENSG00000059122.12	103	214	317	-1.05496645922	SG046	S80
X	11136239	11683821	ENSG00000047648.17	33	2	35	4.04439411936	SG022	S12
5	134669852	134734969	ENSG00000113648.12	468	332	800	0.495325288236	SG042	S84
14	50085237	50087403	ENSG00000165502.6	13	38	51	-1.5474877953	SG031	S95
22	36649056	36663576	ENSG00000100342.16	17	77	94	-2.1793236994400003	SG043	S61
14	20937113	20945253	ENSG00000198805.7	205	142	347	0.529732980001	SG003	S2
6	6144318	6321246	ENSG00000124491.11	130	530	660	-2.0274807364200003	SG001	S25
2	36583069	36778278	ENSG00000150938.5	84	162	246	-0.947532580106	SG042	S84
9	139956581	139965040	ENSG00000186193.7	0	15	15	-inf	SG003	S27
2	239008798	239041928	ENSG00000144488.10	44	14	58	1.65207669658	SG026	S18
16	57392684	57400102	ENSG00000102962.4	521	346	867	0.590511334642	SG025	S34
1	183441351	183567381	ENSG00000116698.16	151	92	243	0.714842783268	SG150	S92
9	77675489	77703133	ENSG00000106733.16	55	18	73	1.61143471208	SG148	S67
22	23247030	23247205	ENSG00000211678.2	0	47	47	-inf	SG039	S75
3	195754054	195809060	ENSG00000072274.8	191	270	461	-0.499386769015	SG003	S27
6	74104857	74127292	ENSG00000080007.6	0	13	13	-inf	SG043	S62
7	56078744	56119297	ENSG00000146733.9	5	117	122	-4.5484366247	SG043	S62
17	4843547	4848517	ENSG00000108523.11	95	37	132	1.3604022427000002	SG022	S12
17	54869274	54916134	ENSG00000214226.4	62	31	93	1.0	SG043	S62
16	1494935	1525581	ENSG00000103249.13	235	315	550	-0.422691071822	SG031	S95
1	169631245	169823221	ENSG00000000460.12	141	73	214	0.949726793519	SG155	S41
20	3734155	3749034	ENSG00000101220.13	70	122	192	-0.801454320618	SG151	S88
2	239008798	239041928	ENSG00000144488.10	50	18	68	1.47393118833	SG042	S60
X	152599613	152625568	ENSG00000063587.12	20	51	71	-1.35049724708	SG003	S27
X	12809474	12842341	ENSG00000101911.8	68	24	92	1.50250034053	SG003	S2
17	7341592	7348256	ENSG00000161958.6	92	48	140	0.938599455336	SG045	S55
13	46700055	46786006	ENSG00000136167.9	1904	1666	3570	0.192645077942	SG043	S61
16	89154783	89222254	ENSG00000176715.11	117	176	293	-0.589066899054	SG151	S88
1	39997510	40024379	ENSG00000243970.1	10	55	65	-2.45943161864	SG148	S71
X	118892576	118894164	ENSG00000187808.3	1	28	29	-4.80735492206	SG046	S81
17	25956824	25976586	ENSG00000168961.12	216	143	359	0.595016165385	SG006	S29
16	89627065	89630950	ENSG00000167526.9	227	135	362	0.7497328902399999	SG069	S24
15	85923802	86292586	ENSG00000170776.15	658	510	1168	0.367590336876	SG031	S95
8	1710156	1712668	ENSG00000253982.1	5	22	27	-2.13750352375	SG031	S95
17	36337711	36358166	ENSG00000197681.8	11	0	11	inf	SG152	S91
6	154331631	154568001	ENSG00000112038.13	165	107	272	0.624855227845	SG022	S12
8	144349603	144359101	ENSG00000250571.2	79	141	220	-0.8357706042219999	SG148	S67
5	162864575	162873157	ENSG00000113328.14	28	61	89	-1.12338241551	SG022	S11
17	79523913	79604172	ENSG00000182446.9	813	564	1377	0.527560189676	SG039	S74
19	49375649	49379314	ENSG00000087074.7	709	961	1670	-0.438750803534	SG152	S91
16	79336	88321	ENSG00000226942.2	3	28	31	-3.22239242134	SG043	S62
7	151038785	151075535	ENSG00000013374.11	186	273	459	-0.553598329812	SG043	S62
5	96149731	96271097	ENSG00000247121.2	401	66	467	2.6030643071	SG006	S29
4	331603	378653	ENSG00000131127.9	24	0	24	inf	SG155	S42
14	106733144	106733639	ENSG00000211950.2	84	0	84	inf	SG006	S29
1	161676762	161684142	ENSG00000132185.12	115	360	475	-1.64636304539	SG031	S95
14	106383838	106391825	ENSG00000226777.3	843	25	868	5.07553263117	SG002	S7
19	50433021	50437192	ENSG00000169136.4	2286	761	3047	1.58685704471	SG043	S85
22	49808176	50051190	ENSG00000188511.8	42	79	121	-0.911463325398	SG149	S66
12	112856155	112947717	ENSG00000179295.11	88	48	136	0.874469117916	SG031	S95
8	22132810	22215076	ENSG00000197181.7	1	33	34	-5.04439411936	SG152	S91
X	47441712	47446188	ENSG00000102265.7	36	109	145	-1.59825932333	SG007	S5
2	242045514	242088919	ENSG00000115687.9	223	137	360	0.7028678169600001	SG021	S38
16	56965960	56977798	ENSG00000051108.10	24	0	24	inf	SG025	S10
9	77675489	77703133	ENSG00000106733.16	52	23	75	1.17687776208	SG040	S50
12	9848414	9848823	ENSG00000213443.2	72	153	225	-1.08746284125	SG003	S2
20	47835884	47860614	ENSG00000124228.10	161	104	265	0.630477159974	SG003	S27
5	133484633	133512729	ENSG00000113558.14	47	18	65	1.38466385024	SG011	S9
5	177019159	177023125	ENSG00000184840.7	123	237	360	-0.946228743559	SG027	S22
7	2477398	2487485	ENSG00000175873.3	56	21	77	1.41503749928	SG022	S12
5	4974803	5034380	ENSG00000250481.1	84	16	100	2.39231742278	SG030	S21
6	159186773	159240444	ENSG00000092820.13	368	275	643	0.420274147645	SG001	S26
20	61640735	61716423	ENSG00000272259.1	5	31	36	-2.6322682155000003	SG027	S45
X	122993574	123047829	ENSG00000101966.8	38	9	47	2.078002512	SG038	S52
9	77675489	77703133	ENSG00000106733.16	44	14	58	1.65207669658	SG007	S6
6	106959730	107018326	ENSG00000112297.10	49	20	69	1.29278174923	SG046	S81
20	34213953	34252878	ENSG00000214078.7	206	110	316	0.905140813659	SG045	S55
17	78143791	78183062	ENSG00000141527.12	28	6	34	2.22239242134	SG041	S82
4	38773860	38784611	ENSG00000174123.6	183	277	460	-0.598042327765	SG003	S27
22	39853349	39888199	ENSG00000128268.11	80	137	217	-0.776103988073	SG011	S32
10	73724123	73773322	ENSG00000122863.5	2	28	30	-3.80735492206	SG027	S45
7	134777115	134855547	ENSG00000122783.12	446	290	736	0.620990809905	SG043	S62
1	234782035	234818922	ENSG00000228044.2	57	22	79	1.37345839553	SG039	S75
15	91163239	91260372	ENSG00000259736.1	50	103	153	-1.04264433741	SG031	S95
4	39289076	39367995	ENSG00000035928.10	41	126	167	-1.6197279188799998	SG021	S38
12	42475647	42538681	ENSG00000151233.6	0	31	31	-inf	SG003	S3
1	75171170	75198835	ENSG00000116791.9	73	138	211	-0.918699897898	SG042	S60
8	98787285	98865241	ENSG00000104341.12	51	12	63	2.08746284125	SG006	S28
2	208527099	208531748	ENSG00000224137.1	5	27	32	-2.43295940728	SG152	S91
1	6051526	6161253	ENSG00000069424.10	630	818	1448	-0.376749014554	SG150	S93
20	627259	634014	ENSG00000271303.1	3	26	29	-3.11547721742	SG030	S43
1	9294834	9331396	ENSG00000049239.8	144	210	354	-0.544320516224	SG024	S13
22	22550113	22550860	ENSG00000211640.3	879	153	1032	2.52233151245	SG006	S4
X	148558521	148602635	ENSG00000010404.13	22	180	202	-3.03242147769	SG022	S11
9	116135699	116139279	ENSG00000119431.5	29	0	29	inf	SG022	S11
2	89291928	89292450	ENSG00000240671.1	19	61	80	-1.68280982412	SG041	S58
16	2961938	3001209	ENSG00000059122.12	104	220	324	-1.08091999538	SG038	S76
5	10654332	10657928	ENSG00000272016.1	402	298	700	0.431883170717	SG040	S73
7	151073030	151107813	ENSG00000187260.11	195	115	310	0.761840262805	SG151	S64
6	25279306	25620758	ENSG00000079691.15	43	6	49	2.84130225398	SG046	S80
16	103010	107669	ENSG00000161981.6	36	139	175	-1.94901607128	SG001	S25
7	134868590	134896316	ENSG00000105875.9	1472	1018	2490	0.5320401099809999	SG042	S84
1	220921567	220958150	ENSG00000117791.11	2	23	25	-3.52356195606	SG039	S75
8	101487903	101513376	ENSG00000253666.1	32	67	99	-1.06608919046	SG043	S61
16	66637777	66647795	ENSG00000140931.15	20	2	22	3.32192809489	SG043	S62
16	4666494	4740975	ENSG00000102858.8	188	266	454	-0.500693583824	SG024	S13
13	43136872	43182149	ENSG00000120659.10	6	32	38	-2.41503749928	SG040	S73
22	23222886	23223576	ENSG00000211673.2	534	108	642	2.3058084295200003	SG022	S12
12	56915713	56984745	ENSG00000076067.7	13	1	14	3.70043971814	SG043	S61
6	160390131	160534539	ENSG00000197081.8	103	58	161	0.8285195320559999	SG069	S24
17	63524681	63557765	ENSG00000168646.8	15	0	15	inf	SG149	S90
3	122399465	122449687	ENSG00000173193.9	783	453	1236	0.789501257245	SG038	S52
11	75145685	75236948	ENSG00000158555.10	44	7	51	2.65207669658	SG031	S23
3	190931080	190952394	ENSG00000233308.1	9	35	44	-1.9593580155	SG155	S19
2	38294652	38337044	ENSG00000138061.7	7	31	38	-2.14684138833	SG001	S26
15	57592563	57599959	ENSG00000247982.2	290	122	412	1.24917175245	SG044	S86
8	98285717	98290176	ENSG00000180543.3	20	1	21	4.3219280948900005	SG043	S61
7	128784712	128808637	ENSG00000158457.4	212	321	533	-0.598509032559	SG039	S51
20	37049235	37063996	ENSG00000196756.7	120	64	184	0.906890595609	SG155	S41
4	169784921	169931426	ENSG00000145439.7	21	51	72	-1.28010791919	SG025	S33
17	906912	1132315	ENSG00000159842.10	321	239	560	0.425562679142	SG045	S79
2	1635659	1748624	ENSG00000130508.6	7	50	57	-2.83650126772	SG149	S89
13	111267881	111291674	ENSG00000213995.7	137	82	219	0.7404800783419999	SG024	S36
22	17517460	17541715	ENSG00000237438.2	44	103	147	-1.22706890855	SG039	S51
19	36233365	36235882	ENSG00000161265.10	52	15	67	1.79354912253	SG022	S12
1	31205316	31230667	ENSG00000162511.7	541	711	1252	-0.394220965793	SG030	S21
11	58938903	58975982	ENSG00000110042.3	23	54	77	-1.23132554611	SG023	S96
2	228029281	228179508	ENSG00000169031.14	64	13	77	2.29956028186	SG002	S7
5	134262350	134263719	ENSG00000247627.2	18	2	20	3.16992500144	SG027	S44
12	113345433	113455556	ENSG00000257452.1	2000	1750	3750	0.192645077942	SG150	S93
10	73724123	73773322	ENSG00000122863.5	20	0	20	inf	SG001	S26
11	287305	288987	ENSG00000255026.1	23	5	28	2.20163386117	SG155	S19
16	1543345	1560427	ENSG00000100726.10	193	128	321	0.592457037268	SG027	S45
22	23222886	23223576	ENSG00000211673.2	280	52	332	2.4288432988	SG148	S67
5	156693089	156822541	ENSG00000055163.14	241	348	589	-0.530054159619	SG149	S90
X	69664711	69725337	ENSG00000082458.7	28	4	32	2.80735492206	SG022	S12
15	31231144	31283810	ENSG00000166912.12	172	108	280	0.671377252539	SG044	S63
2	213446081	213886269	ENSG00000273118.1	345	436	781	-0.337731773111	SG042	S84
11	832884	839720	ENSG00000177697.13	148	45	193	1.7176002693	SG025	S33
21	38445526	38575413	ENSG00000182670.9	119	178	297	-0.580915667658	SG155	S41
19	10444452	10450499	ENSG00000076662.5	458	583	1041	-0.348148285104	SG006	S4
18	74240612	74322925	ENSG00000263812.1	49	21	70	1.22239242134	SG155	S19
16	1832902	1839192	ENSG00000095906.12	375	504	879	-0.426533138117	SG001	S1
15	81451916	81601393	ENSG00000172349.12	55	139	194	-1.3375813592	SG006	S28
22	24236770	24241117	ENSG00000218537.1	4	30	34	-2.90689059561	SG011	S8
X	153172821	153193873	ENSG00000089820.11	186	39	225	2.25375659225	SG031	S46
8	11415975	11417529	ENSG00000255354.1	137	82	219	0.7404800783419999	SG031	S46
3	126156444	126194762	ENSG00000070476.10	40	91	131	-1.18586654531	SG150	S92
4	25749055	25865382	ENSG00000091490.6	30	65	95	-1.11547721742	SG149	S90
12	120634489	120639038	ENSG00000089157.11	1004	1243	2247	-0.308067027102	SG045	S55
19	16177831	16213813	ENSG00000167460.10	164	281	445	-0.7768743156029999	SG152	S68
X	65815479	65859108	ENSG00000131080.10	103	9	112	3.51657552574	SG022	S35
19	54024235	54083523	ENSG00000130844.12	37	9	46	2.03952836419	SG043	S61
1	207669492	207813992	ENSG00000203710.6	6	26	32	-2.11547721742	SG024	S37
18	51795774	51847636	ENSG00000101751.6	15	43	58	-1.51937415909	SG040	S49
19	9523272	9546254	ENSG00000174652.13	146	62	208	1.23562824849	SG044	S63
13	27998681	28009775	ENSG00000122034.8	198	135	333	0.552541023029	SG046	S80
19	2037470	2051243	ENSG00000099875.10	1705	1387	3092	0.297803951588	SG038	S53
22	42905974	42915808	ENSG00000189306.6	109	217	326	-0.993366907668	SG038	S52
5	96149731	96271097	ENSG00000247121.2	490	82	572	2.57908593438	SG006	S4
10	30722866	30750762	ENSG00000107968.5	264	443	707	-0.746768769197	SG148	S71
14	107113741	107114274	ENSG00000223648.2	37	7	44	2.40209844357	SG024	S37
3	52558512	52569070	ENSG00000168268.6	134	50	184	1.42223300068	SG042	S60
12	110872630	110888212	ENSG00000111229.11	322	443	765	-0.46024601044	SG040	S49
22	22781876	22782371	ENSG00000211654.2	21	0	21	inf	SG023	S96
1	230193536	230417870	ENSG00000143641.8	690	493	1183	0.4850087152880001	SG155	S42
5	95860971	96115299	ENSG00000153113.19	578	332	910	0.799886251154	SG044	S63
9	5450503	5470566	ENSG00000120217.9	252	343	595	-0.444784842673	SG042	S83
11	58346584	58388515	ENSG00000186660.14	67	31	98	1.11189288007	SG021	S38
2	113399409	113403267	ENSG00000237753.1	2	16	18	-3.0	SG046	S81
17	42396993	42402238	ENSG00000013306.11	48	104	152	-1.11547721742	SG021	S14
17	79617489	79630142	ENSG00000185527.7	145	83	228	0.804869658668	SG039	S74
4	42410390	42659122	ENSG00000124406.12	90	144	234	-0.678071905113	SG043	S62
20	52553316	52687304	ENSG00000064787.8	52	12	64	2.11547721742	SG024	S13
14	100800125	100843142	ENSG00000140105.13	244	362	606	-0.56910854952	SG069	S47
X	20168029	20285523	ENSG00000177189.8	65	10	75	2.70043971814	SG038	S53
14	106383838	106391825	ENSG00000226777.3	67	18	85	1.89616418902	SG042	S84
11	65190245	65213011	ENSG00000245532.4	324	179	503	0.8560342256199999	SG044	S63
17	48623667	48633213	ENSG00000006282.15	23	126	149	-2.4537179674400003	SG022	S11
4	5712924	5830772	ENSG00000072840.8	0	28	28	-inf	SG025	S10
2	20760208	20850849	ENSG00000118960.8	44	88	132	-1.0	SG046	S80
19	18682540	18688360	ENSG00000221983.3	579	444	1023	0.383003671639	SG152	S91
5	6599352	6633404	ENSG00000037474.10	242	155	397	0.642738832	SG038	S53
1	227177566	227506175	ENSG00000143776.14	1	70	71	-6.12928301694	SG011	S32
17	33570055	33600674	ENSG00000166750.5	30	555	585	-4.20945336563	SG024	S13
5	180467225	180488523	ENSG00000165810.12	81	1	82	6.33985000288	SG031	S46
22	22657589	22664766	ENSG00000272779.1	26	67	93	-1.36564947232	SG027	S45
15	91473410	91497323	ENSG00000140553.12	1	16	17	-4.0	SG151	S88
10	104474295	104503249	ENSG00000156398.8	25	4	29	2.64385618977	SG001	S1
5	96149731	96271097	ENSG00000247121.2	230	42	272	2.45317262817	SG026	S17
18	9708162	9862548	ENSG00000168461.8	57	5	62	3.51096191928	SG151	S88
12	104323990	104347423	ENSG00000166598.8	1141	984	2125	0.213568570949	SG155	S42
6	42931619	42946958	ENSG00000124587.9	56	112	168	-1.0	SG022	S35
X	70338406	70362303	ENSG00000184634.11	7	40	47	-2.51457317283	SG038	S53
X	13395307	13421138	ENSG00000226434.1	0	30	30	-inf	SG025	S34
3	47057919	47205457	ENSG00000181555.15	19	53	72	-1.47999294112	SG006	S28
19	9523272	9546254	ENSG00000174652.13	128	61	189	1.06926266244	SG040	S73
2	114647537	114720173	ENSG00000115091.7	323	235	558	0.458873408129	SG006	S28
22	43013846	43045574	ENSG00000100243.16	360	265	625	0.442004546879	SG022	S12
6	3849620	3851551	ENSG00000145945.5	38	0	38	inf	SG021	S38
16	1494935	1525581	ENSG00000103249.13	514	277	791	0.891882383145	SG039	S51
12	6571489	6580153	ENSG00000139190.12	210	285	495	-0.440572591386	SG023	S39
3	40498783	40503861	ENSG00000188846.9	378	256	634	0.562242424221	SG024	S13
3	16355081	16555533	ENSG00000131378.9	218	294	512	-0.4314880200590001	SG155	S42
1	3728645	3773778	ENSG00000116198.8	116	201	317	-0.7930706960510001	SG148	S71
1	206238872	206288647	ENSG00000196533.6	68	121	189	-0.8314003960240001	SG025	S33
7	128577666	128590089	ENSG00000128604.14	192	30	222	2.67807190511	SG026	S18
20	61640735	61716423	ENSG00000272259.1	257	123	380	1.06311004385	SG025	S34
6	167342992	167370672	ENSG00000026297.11	697	962	1659	-0.464878237902	SG152	S91
8	101269288	101348446	ENSG00000034677.7	55	20	75	1.4594316186399998	SG046	S81
14	64550950	64770377	ENSG00000140009.14	315	206	521	0.6127074912039999	SG149	S89
7	1200121	1204903	ENSG00000229043.2	87	41	128	1.08539149123	SG040	S49
13	48877911	49056122	ENSG00000139687.9	42	1	43	5.39231742278	SG043	S61
19	35810164	35838258	ENSG00000012124.10	1050	749	1799	0.487351704095	SG046	S80
X	148558521	148602635	ENSG00000010404.13	258	122	380	1.08048991786	SG148	S71
2	101618707	101640494	ENSG00000071082.6	57	23	80	1.30932805811	SG148	S94
4	331603	378653	ENSG00000131127.9	92	38	130	1.27563444261	SG026	S18
1	169659808	169680839	ENSG00000188404.4	211	133	344	0.665816753206	SG069	S24
19	2977444	2995177	ENSG00000104953.14	3	20	23	-2.73696559417	SG030	S21
11	10329860	10529126	ENSG00000133805.11	74	35	109	1.0801703486799998	SG026	S18
1	169631245	169823221	ENSG00000000460.12	254	164	418	0.631132682154	SG069	S47
X	11129421	11141198	ENSG00000004961.10	54	16	70	1.75488750216	SG148	S71
20	361261	378203	ENSG00000101255.6	63	108	171	-0.777607578664	SG006	S28
3	121350246	121379774	ENSG00000180353.6	438	598	1036	-0.449214614597	SG025	S34
1	160709037	160724611	ENSG00000026751.12	459	720	1179	-0.649502752916	SG007	S6
16	475619	573011	ENSG00000090565.11	0	46	46	-inf	SG031	S95
17	5402747	5522744	ENSG00000091592.11	715	456	1171	0.6489094175010001	SG152	S91
19	2071037	2096331	ENSG00000172081.9	1016	823	1839	0.303936066351	SG150	S69
17	27900487	27921072	ENSG00000108262.11	17	46	63	-1.43609911481	SG002	S72
8	22132810	22215076	ENSG00000197181.7	1	61	62	-5.93073733756	SG152	S70
12	63359095	63359764	ENSG00000139239.6	0	37	37	-inf	SG041	S59
16	89642176	89663654	ENSG00000178773.10	32	113	145	-1.82017896242	SG023	S96
15	81451916	81601393	ENSG00000172349.12	398	566	964	-0.508033622288	SG152	S70
1	39997510	40024379	ENSG00000243970.1	1	17	18	-4.08746284125	SG152	S91
19	1248552	1259142	ENSG00000167470.8	10	33	43	-1.72246602447	SG027	S44
22	45704849	45737836	ENSG00000100376.7	68	15	83	2.18057224564	SG026	S40
17	45900638	45908900	ENSG00000159111.8	128	78	206	0.714597781138	SG069	S24
10	91174343	91180758	ENSG00000152778.7	24	56	80	-1.22239242134	SG038	S52
4	2743375	2758103	ENSG00000168884.10	267	362	629	-0.439149955396	SG150	S69
X	73183790	73513409	ENSG00000230590.3	28	2	30	3.80735492206	SG022	S35
8	28174503	28200872	ENSG00000168081.4	134	296	430	-1.14336417517	SG003	S27
11	71139239	71163914	ENSG00000172893.11	26	5	31	2.37851162325	SG025	S33
8	11351510	11422113	ENSG00000136573.8	114	303	417	-1.41028396931	SG151	S64
2	30454397	30546596	ENSG00000213626.7	43	90	133	-1.0655883416299998	SG069	S24
16	2961938	3001209	ENSG00000059122.12	128	68	196	0.91253715875	SG155	S42
X	154425284	154468098	ENSG00000155959.6	12	62	74	-2.36923380967	SG038	S53
12	120634489	120639038	ENSG00000089157.11	2228	1870	4098	0.252710962565	SG040	S49
16	89940014	89977792	ENSG00000141002.14	238	170	408	0.48542682717	SG023	S39
5	96149731	96271097	ENSG00000247121.2	491	111	602	2.14516334796	SG025	S34
X	47511197	47518231	ENSG00000126756.7	13	0	13	inf	SG038	S53
3	12837971	12913415	ENSG00000144712.7	1325	1534	2859	-0.211306123165	SG030	S43
6	57179603	57513375	ENSG00000146143.13	24	3	27	3.0	SG155	S42
6	37600284	37667082	ENSG00000112139.10	3	35	38	-3.54432051622	SG038	S53
1	28835071	28835274	ENSG00000200087.1	0	15	15	-inf	SG045	S79
3	151961617	152183569	ENSG00000152601.13	50	11	61	2.18442457114	SG001	S25
1	93727743	93811444	ENSG00000223745.3	197	115	312	0.776561768512	SG155	S41
14	64550950	64770377	ENSG00000140009.14	605	426	1031	0.506081711936	SG046	S57
8	26240470	26270645	ENSG00000104765.10	182	96	278	0.922832139478	SG045	S55
17	36342584	36421841	ENSG00000174093.6	47	5	52	3.23266075679	SG042	S83
5	131817301	131826490	ENSG00000125347.9	243	326	569	-0.423915650625	SG024	S13
19	2071037	2096331	ENSG00000172081.9	299	193	492	0.6315446369300001	SG027	S45
9	74729511	74872109	ENSG00000119125.12	17	2	19	3.08746284125	SG151	S64
15	45653322	45694525	ENSG00000171766.11	223	155	378	0.5247754946459999	SG151	S88
12	6775643	6798676	ENSG00000126746.13	19	2	21	3.2479275134400005	SG021	S38
5	96149731	96271097	ENSG00000247121.2	221	639	860	-1.5317695615600002	SG149	S66
14	106383838	106391825	ENSG00000226777.3	212	120	332	0.821029858955	SG151	S88
17	16245848	16256813	ENSG00000166582.5	70	35	105	1.0	SG022	S11
20	57393974	57425958	ENSG00000235590.3	0	13	13	-inf	SG022	S12
4	10488019	10686489	ENSG00000109684.10	243	144	387	0.7548875021629999	SG024	S13
15	91426925	91439006	ENSG00000182511.7	5	28	33	-2.48542682717	SG041	S82
6	74123238	74161999	ENSG00000164430.11	10	35	45	-1.80735492206	SG003	S3
12	117476728	117537284	ENSG00000088992.13	32	5	37	2.67807190511	SG040	S49
17	49242796	49249108	ENSG00000243678.7	381	288	669	0.403722186051	SG155	S42
6	149068464	149398126	ENSG00000111962.7	2	24	26	-3.58496250072	SG043	S61
13	24982295	25171814	ENSG00000205822.6	154	218	372	-0.5013977840820001	SG152	S68
22	42905974	42915808	ENSG00000189306.6	90	179	269	-0.991962680935	SG155	S42
14	106452671	106453170	ENSG00000211934.2	24	2	26	3.58496250072	SG026	S40
1	160648536	160681641	ENSG00000117091.5	1050	793	1843	0.40499655685	SG024	S36
9	113006091	113018920	ENSG00000136810.8	313	468	781	-0.580345872651	SG037	S78
11	117298489	117688240	ENSG00000177103.9	9	32	41	-1.83007499856	SG041	S82
19	571297	583493	ENSG00000172270.14	1630	1301	2931	0.325251002401	SG007	S6
15	38780304	38857776	ENSG00000172575.7	32	71	103	-1.1497471195	SG041	S82
5	180467225	180488523	ENSG00000165810.12	73	3	76	4.60486205816	SG042	S84
8	8640864	8751155	ENSG00000147324.6	125	187	312	-0.5811101752260001	SG046	S57
19	983174	994569	ENSG00000065268.6	90	41	131	1.13430109171	SG150	S92
14	59927081	59951148	ENSG00000126790.7	121	51	172	1.2464378953	SG044	S63
19	54960224	54972980	ENSG00000167615.12	357	479	836	-0.424101581707	SG151	S64
22	39493229	39500072	ENSG00000100298.11	140	199	339	-0.5073416035989999	SG148	S71
17	25956824	25976586	ENSG00000168961.12	250	348	598	-0.477159211187	SG024	S13
1	14026693	14151574	ENSG00000116731.18	184	114	298	0.690671941892	SG007	S5
16	81812863	81991899	ENSG00000197943.5	294	208	502	0.499232626695	SG011	S32
14	55590828	55612121	ENSG00000131981.11	425	83	508	2.35627959968	SG043	S62
1	26126667	26144713	ENSG00000162430.12	15	63	78	-2.07038932789	SG038	S53
7	6061881	6098861	ENSG00000086232.8	137	211	348	-0.623067105747	SG039	S74
12	9848414	9848823	ENSG00000213443.2	21	60	81	-1.5145731728299998	SG041	S58
X	135295381	135338641	ENSG00000129680.11	14	46	60	-1.716207034	SG007	S30
21	46188955	46221934	ENSG00000184787.14	143	209	352	-0.547487795302	SG021	S15
8	145159402	145162514	ENSG00000179632.5	216	148	364	0.545434136535	SG046	S57
22	41601209	41627275	ENSG00000100395.10	146	82	228	0.832272554262	SG042	S60
11	58346584	58388515	ENSG00000186660.14	151	221	372	-0.549497820066	SG003	S3
3	121350246	121379774	ENSG00000180353.6	1167	979	2146	0.253423796104	SG024	S36
11	7534529	7678358	ENSG00000166387.7	152	91	243	0.740132873245	SG031	S46
12	131438452	131626014	ENSG00000111452.8	39	9	48	2.11547721742	SG039	S51
19	18683418	18718551	ENSG00000006016.6	561	451	1012	0.314873337353	SG030	S21
6	12514342	12515006	ENSG00000212802.3	106	0	106	inf	SG002	S72
2	38294652	38337044	ENSG00000138061.7	13	49	62	-1.91427012597	SG039	S75
1	210501596	210849638	ENSG00000054392.8	3	20	23	-2.73696559417	SG003	S2
4	76831809	76862102	ENSG00000138744.10	9	38	47	-2.078002512	SG155	S41
5	151040657	151064791	ENSG00000113140.6	102	47	149	1.11783649029	SG007	S5
X	37639264	37672714	ENSG00000165168.6	173	13	186	3.7341885095	SG046	S57
9	25676396	25678856	ENSG00000198680.3	1	14	15	-3.80735492206	SG148	S94
7	1036622	1177896	ENSG00000146540.10	1025	1453	2478	-0.5034107932399999	SG022	S35
9	35675864	35681156	ENSG00000107159.8	0	32	32	-inf	SG155	S42
5	1456595	1524092	ENSG00000153395.5	497	305	802	0.704436609112	SG024	S36
1	21766621	21811498	ENSG00000142794.14	0	11	11	-inf	SG031	S46
19	54960224	54972980	ENSG00000167615.12	554	365	919	0.601989512282	SG041	S82
9	6716548	6727438	ENSG00000225489.2	25	1	26	4.64385618977	SG002	S7
10	135075907	135090372	ENSG00000151651.11	949	1118	2067	-0.236440195822	SG044	S86
17	42247815	42256451	ENSG00000161664.2	54	16	70	1.75488750216	SG148	S71
12	113376157	113411054	ENSG00000111331.8	1059	1520	2579	-0.521368734339	SG043	S62
5	10654332	10657928	ENSG00000272016.1	437	341	778	0.357861540476	SG148	S71
7	77166592	77269388	ENSG00000127947.11	73	38	111	0.941897045436	SG031	S95
1	160577890	160617085	ENSG00000117090.10	1246	1480	2726	-0.248293107492	SG151	S65
3	78646390	79816965	ENSG00000169855.15	19	49	68	-1.36678233067	SG148	S71
11	121322912	121504402	ENSG00000137642.8	298	197	495	0.597116701006	SG150	S69
7	134777115	134855547	ENSG00000122783.12	42	0	42	inf	SG151	S65
10	134000404	134019280	ENSG00000151640.8	0	19	19	-inf	SG037	S78
11	289138	296107	ENSG00000142102.11	93	166	259	-0.835880620239	SG022	S12
3	192514604	192635950	ENSG00000180611.6	9	38	47	-2.078002512	SG024	S36
17	57187312	57232630	ENSG00000182628.8	21	2	23	3.39231742278	SG002	S31
19	54960224	54972980	ENSG00000167615.12	378	494	872	-0.386124807364	SG151	S65
7	64139332	64147771	ENSG00000271550.1	23	55	78	-1.25779775747	SG007	S5
22	24129150	24176689	ENSG00000099956.13	212	299	511	-0.496081219635	SG007	S30
13	111293764	111365624	ENSG00000134905.12	208	282	490	-0.439111634258	SG043	S62
2	132222473	132250316	ENSG00000173272.9	75	197	272	-1.39323312896	SG011	S32
22	37611778	37611931	ENSG00000226233.1	0	16	16	-inf	SG038	S52
17	80400522	80408705	ENSG00000178927.12	620	473	1093	0.390428031935	SG038	S76
8	98787285	98865241	ENSG00000104341.12	27	1	28	4.75488750216	SG026	S18
16	89627065	89630950	ENSG00000167526.9	332	231	563	0.5232903899310001	SG042	S60
19	3630181	3700477	ENSG00000186111.4	61	127	188	-1.05794734921	SG155	S42
19	39833036	39876350	ENSG00000179134.10	106	58	164	0.869939459436	SG149	S66
3	45730678	45786916	ENSG00000211456.6	18	2	20	3.16992500144	SG151	S64
11	2316875	2324279	ENSG00000110665.7	0	16	16	-inf	SG022	S35
1	38326369	38412729	ENSG00000204084.8	142	86	228	0.723482364803	SG038	S52
19	18682540	18688360	ENSG00000221983.3	723	504	1227	0.520571913451	SG038	S76
15	31514202	31523041	ENSG00000259772.2	117	57	174	1.0374747054200002	SG151	S88
13	43597339	43683045	ENSG00000120675.4	102	158	260	-0.631355406206	SG002	S31
12	29433351	29470781	ENSG00000257176.1	21	4	25	2.39231742278	SG025	S33
17	16826229	16838153	ENSG00000128438.6	379	615	994	-0.698388562056	SG069	S47
17	76481116	76493118	ENSG00000267432.1	18	118	136	-2.71271804792	SG043	S62
11	43577986	43878160	ENSG00000149084.7	61	111	172	-0.863678528787	SG037	S78
1	111729796	111747157	ENSG00000162777.12	84	139	223	-0.726623649945	SG044	S86
5	179261436	179285887	ENSG00000161010.10	104	158	262	-0.603341030036	SG155	S41
17	36337711	36358166	ENSG00000197681.8	0	14	14	-inf	SG151	S65
2	231385309	231444721	ENSG00000235419.1	29	4	33	2.85798099513	SG039	S75
19	281040	291393	ENSG00000141934.5	0	15	15	-inf	SG003	S3
7	33053742	33102409	ENSG00000122643.14	120	44	164	1.44745897697	SG025	S33
8	564746	688106	ENSG00000104714.9	87	244	331	-1.48779384171	SG155	S19
1	150190717	150208504	ENSG00000143401.10	111	50	161	1.15055967658	SG151	S65
14	106202680	106209408	ENSG00000211896.2	0	14	14	-inf	SG038	S53
15	86287340	86293512	ENSG00000259407.1	332	460	792	-0.470450619597	SG155	S41
11	60223225	60238233	ENSG00000156738.13	354	452	806	-0.352573412332	SG021	S14
15	45003675	45011075	ENSG00000166710.13	2827	3104	5931	-0.134856674356	SG042	S60
5	174904065	174956745	ENSG00000164466.8	202	285	487	-0.4966066263	SG006	S28
17	33570055	33600674	ENSG00000166750.5	167	10	177	4.06177619759	SG011	S9
17	33570055	33600674	ENSG00000166750.5	26	288	314	-3.4694852833	SG069	S24
19	48551100	48614074	ENSG00000105499.9	13	51	64	-1.97198562383	SG151	S64
1	54317392	54356407	ENSG00000058799.9	48	16	64	1.58496250072	SG007	S5
22	19348760	19435415	ENSG00000242259.4	157	92	249	0.771058792835	SG149	S90
13	96453834	96705736	ENSG00000102595.14	5	44	49	-3.13750352375	SG040	S49
10	45869661	45941561	ENSG00000012779.6	62	142	204	-1.19555080912	SG011	S8
11	61583728	61634826	ENSG00000134824.9	587	458	1045	0.358012905013	SG001	S1
1	11994262	12035595	ENSG00000083444.12	24	60	84	-1.3219280948899998	SG021	S14
6	57179603	57513375	ENSG00000146143.13	6	25	31	-2.05889368905	SG026	S18
11	2465914	2870339	ENSG00000053918.11	19	0	19	inf	SG006	S4
13	115000362	115038198	ENSG00000130177.10	173	115	288	0.5891381766920001	SG003	S2
X	47420516	47431302	ENSG00000078061.8	74	18	92	2.03952836419	SG046	S80
14	105475910	105487485	ENSG00000170779.10	407	299	706	0.444883310068	SG022	S12
1	40538379	40563375	ENSG00000131238.12	152	240	392	-0.658963082165	SG151	S65
19	50372295	50381716	ENSG00000204673.6	15	44	59	-1.55254102303	SG024	S13
X	118749687	118827333	ENSG00000125354.18	3	42	45	-3.80735492206	SG046	S81
2	242673994	242708226	ENSG00000180902.12	135	217	352	-0.684735635394	SG149	S89
19	45393826	45406946	ENSG00000130204.8	156	221	377	-0.5025003405290001	SG044	S63
17	1957448	1962981	ENSG00000177374.8	48	16	64	1.58496250072	SG002	S72
1	157483167	157522310	ENSG00000143297.14	717	920	1637	-0.359660742242	SG030	S43
8	33405273	33424643	ENSG00000133874.1	18	51	69	-1.50250034053	SG023	S96
3	12938719	13114617	ENSG00000144711.9	417	293	710	0.509146719022	SG039	S51
8	144063155	144099854	ENSG00000247317.3	30	5	35	2.58496250072	SG040	S73
19	58365144	58376480	ENSG00000198466.8	35	71	106	-1.02046410256	SG046	S80
17	21279509	21323179	ENSG00000184185.5	1	15	16	-3.90689059561	SG150	S93
11	14526420	14665181	ENSG00000129084.13	25	5	30	2.32192809489	SG045	S79
19	18283972	18288927	ENSG00000216490.3	1102	1410	2512	-0.355570938715	SG152	S70
14	106452671	106453170	ENSG00000211934.2	0	54	54	-inf	SG003	S27
1	161676762	161684142	ENSG00000132185.12	280	134	414	1.0631938264899998	SG040	S73
2	113973574	114036527	ENSG00000125618.12	0	85	85	-inf	SG027	S22
17	78075355	78093678	ENSG00000171298.8	6	67	73	-3.4811266897400004	SG045	S55
10	18429606	18830514	ENSG00000165995.14	12	38	50	-1.6629650127200002	SG002	S31
2	114647537	114720173	ENSG00000115091.7	559	449	1008	0.316132838102	SG151	S88
9	220748	465259	ENSG00000107099.11	138	204	342	-0.563900885193	SG046	S81
7	128577666	128590089	ENSG00000128604.14	230	50	280	2.20163386117	SG151	S65
12	92536286	92539348	ENSG00000133639.3	99	156	255	-0.6560455987830001	SG021	S14
1	40538379	40563375	ENSG00000131238.12	225	145	370	0.633872101202	SG003	S27
X	119759648	119764005	ENSG00000171155.7	33	10	43	1.72246602447	SG040	S49
19	54960224	54972980	ENSG00000167615.12	614	891	1505	-0.537186776152	SG039	S74
10	43881065	43904614	ENSG00000169813.12	122	199	321	-0.7058872829809999	SG037	S54
13	21727734	21750741	ENSG00000165480.11	63	26	89	1.27684020536	SG037	S78
6	53132196	53213947	ENSG00000012660.9	13	39	52	-1.58496250072	SG007	S30
12	92536286	92539348	ENSG00000133639.3	168	111	279	0.597901556429	SG023	S39
1	93727743	93811444	ENSG00000223745.3	183	92	275	0.992137882227	SG025	S34
6	3832167	3855971	ENSG00000238158.2	15	0	15	inf	SG024	S13
X	41374187	41782716	ENSG00000147044.16	33	5	38	2.72246602447	SG046	S80
1	40157854	40229586	ENSG00000084072.12	34	69	103	-1.02106161553	SG025	S10
17	3575493	3599698	ENSG00000083454.17	461	1519	1980	-1.72028321407	SG046	S57
17	56408245	56409869	ENSG00000265206.2	30	63	93	-1.07038932789	SG042	S83
15	91260558	91358859	ENSG00000197299.6	59	102	161	-0.7897822926100001	SG007	S6
11	47487496	47586887	ENSG00000149187.13	24	5	29	2.26303440583	SG025	S10
11	832884	839720	ENSG00000177697.13	70	161	231	-1.2016338611700002	SG155	S42
19	54606036	54612564	ENSG00000170906.11	2	17	19	-3.08746284125	SG151	S65
22	43547520	43559248	ENSG00000100300.13	251	153	404	0.714155711258	SG039	S75
2	89156674	89156708	ENSG00000211592.2	0	55	55	-inf	SG023	S39
12	118501398	118573662	ENSG00000176834.9	18	0	18	inf	SG043	S62
10	7200586	7453450	ENSG00000198879.7	128	187	315	-0.546894459888	SG155	S42
2	219135115	219211516	ENSG00000127838.9	60	104	164	-0.7935491225329999	SG037	S78
16	84599200	84651683	ENSG00000103187.6	282	184	466	0.615989396342	SG030	S21
16	66637777	66647795	ENSG00000140931.15	13	44	57	-1.7589919005	SG042	S84
13	43597339	43683045	ENSG00000120675.4	86	39	125	1.14086253584	SG037	S78
19	3141574	3155173	ENSG00000267551.3	6	32	38	-2.41503749928	SG149	S66
1	6051526	6161253	ENSG00000069424.10	754	959	1713	-0.346966291749	SG041	S58
1	101337943	101361554	ENSG00000162694.9	0	11	11	-inf	SG038	S53
16	2325882	2390747	ENSG00000167972.9	0	15	15	-inf	SG043	S85
11	125439112	125454575	ENSG00000149547.10	20	52	72	-1.37851162325	SG149	S66
7	1200121	1204903	ENSG00000229043.2	111	58	169	0.936434871223	SG006	S4
19	983174	994569	ENSG00000065268.6	162	104	266	0.639410284744	SG149	S89
15	40820882	40857256	ENSG00000128891.11	182	116	298	0.649813645071	SG150	S92
4	15779898	15854853	ENSG00000004468.8	304	212	516	0.5200070588800001	SG045	S79
2	197627756	197664449	ENSG00000119041.6	16	42	58	-1.39231742278	SG152	S91
9	123664671	123691451	ENSG00000056558.6	1387	1095	2482	0.341036917835	SG042	S60
8	564746	688106	ENSG00000104714.9	126	267	393	-1.08341600819	SG155	S42
8	11413760	11415470	ENSG00000255518.1	140	294	434	-1.07038932789	SG039	S74
6	166719168	166721936	ENSG00000176381.4	16	0	16	inf	SG002	S72
2	231068340	231177930	ENSG00000079263.14	379	218	597	0.7978697133939999	SG041	S58
4	89206094	89252573	ENSG00000246375.2	1	16	17	-4.0	SG022	S11
19	18283972	18288927	ENSG00000216490.3	985	1171	2156	-0.249545446157	SG148	S94
19	47123725	47128375	ENSG00000160013.4	38	82	120	-1.1096244911700002	SG152	S68
5	6599352	6633404	ENSG00000037474.10	203	142	345	0.51558879768	SG152	S70
11	11292423	11643552	ENSG00000110328.5	11	36	47	-1.7104933828100002	SG155	S42
17	80400522	80408705	ENSG00000178927.12	271	358	629	-0.40166673591	SG023	S16
2	119981384	120023228	ENSG00000115107.15	33	9	42	1.87446911792	SG069	S47
6	106959730	107018326	ENSG00000112297.10	60	107	167	-0.8345763907930001	SG011	S8
19	1026298	1039068	ENSG00000064666.10	1712	1915	3627	-0.16166169041099998	SG038	S52
8	65500320	65711318	ENSG00000172817.3	29	6	35	2.27301849441	SG043	S62
2	62296582	62364740	ENSG00000229839.2	71	33	104	1.10535300015	SG044	S86
3	150259781	150321015	ENSG00000120742.6	1028	874	1902	0.234135079693	SG039	S74
X	13395307	13421138	ENSG00000226434.1	0	73	73	-inf	SG046	S57
20	4760669	4804291	ENSG00000101265.11	457	356	813	0.360316924092	SG044	S87
20	39765600	39804460	ENSG00000124181.10	80	128	208	-0.678071905113	SG031	S95
22	45586219	45636650	ENSG00000100364.14	106	61	167	0.797183117	SG021	S15
1	213025450	213031430	ENSG00000198468.3	3	21	24	-2.80735492206	SG007	S30
1	245014468	245027844	ENSG00000153187.12	73	129	202	-0.821402696543	SG024	S36
1	2488136	2496821	ENSG00000157873.13	1255	1476	2731	-0.234005357222	SG042	S84
1	111729796	111747157	ENSG00000162777.12	102	14	116	2.86507041991	SG023	S16
6	133135580	133138703	ENSG00000112306.7	1664	1424	3088	0.224706287175	SG043	S85
19	54960224	54972980	ENSG00000167615.12	257	412	669	-0.6808759779889999	SG026	S18
3	67410884	67705038	ENSG00000172340.10	22	60	82	-1.44745897697	SG027	S22
15	50647606	50659636	ENSG00000244879.3	16	56	72	-1.80735492206	SG002	S31
8	79578282	79632000	ENSG00000104427.7	5	24	29	-2.26303440583	SG025	S10
22	27042392	27072438	ENSG00000225783.2	125	70	195	0.836501267717	SG046	S57
15	59427113	59665099	ENSG00000157483.4	128	195	323	-0.60733031375	SG024	S13
X	48830134	48858675	ENSG00000068400.9	86	40	126	1.10433665981	SG148	S71
7	33053742	33102409	ENSG00000122643.14	71	34	105	1.06228427825	SG027	S44
2	152126979	152146571	ENSG00000123609.6	34	68	102	-1.0	SG024	S13
8	128806779	129113499	ENSG00000249859.3	130	192	322	-0.562594687693	SG037	S78
13	111175417	111214080	ENSG00000139832.3	85	33	118	1.36499681678	SG149	S89
1	40157854	40229586	ENSG00000084072.12	1	16	17	-4.0	SG038	S53
16	84599200	84651683	ENSG00000103187.6	790	410	1200	0.946228743559	SG025	S10
9	91975702	92113045	ENSG00000187764.7	212	330	542	-0.638401759683	SG069	S48
16	30389427	30411429	ENSG00000180035.6	361	271	632	0.413705985533	SG041	S58
4	17578815	17609595	ENSG00000002549.8	217	305	522	-0.491114200006	SG002	S72
19	22235254	22274282	ENSG00000197134.7	16	1	17	4.0	SG027	S44
17	53469974	53499353	ENSG00000108960.3	53	97	150	-0.871992387624	SG040	S49
11	43577986	43878160	ENSG00000149084.7	221	109	330	1.01971823461	SG041	S59
13	96453834	96705736	ENSG00000102595.14	23	54	77	-1.23132554611	SG039	S51
9	19375995	19380252	ENSG00000137154.8	83	43	126	0.948774676645	SG021	S15
1	101788893	101855859	ENSG00000231671.1	6	39	45	-2.70043971814	SG021	S14
16	1494935	1525581	ENSG00000103249.13	112	64	176	0.807354922058	SG022	S35
13	99853028	100038688	ENSG00000134882.11	53	14	67	1.92056553251	SG043	S62
14	106382685	106382715	ENSG00000211931.1	14	0	14	inf	SG152	S68
3	122399465	122449687	ENSG00000173193.9	554	1078	1632	-0.960399296703	SG037	S77
19	1086628	1095598	ENSG00000099817.7	64	116	180	-0.857980995128	SG021	S38
3	122296449	122357894	ENSG00000173200.8	309	488	797	-0.6592743096589999	SG031	S95
1	175126123	175162135	ENSG00000235750.5	337	242	579	0.477741543907	SG031	S95
2	113973574	114036527	ENSG00000125618.12	64	8	72	3.0	SG023	S39
15	45003675	45011075	ENSG00000166710.13	3132	2863	5995	0.129556542292	SG041	S59
7	32535038	33078516	ENSG00000105778.13	292	200	492	0.545968369105	SG025	S10
16	57086417	57092409	ENSG00000260145.1	74	33	107	1.16505924627	SG155	S19
1	169818772	169863408	ENSG00000000457.9	40	13	53	1.62148837675	SG023	S96
7	73248920	73256865	ENSG00000165171.6	18	0	18	inf	SG024	S13
17	16826229	16838153	ENSG00000128438.6	293	207	500	0.501269896923	SG023	S16
1	213031597	213072705	ENSG00000162769.8	103	61	164	0.75576318962	SG038	S52
17	37213272	37269443	ENSG00000263818.1	0	11	11	-inf	SG002	S72
6	3020388	3022984	ENSG00000270346.1	4	29	33	-2.85798099513	SG011	S8
20	35136563	35201794	ENSG00000232907.3	19	1	20	4.2479275134400005	SG044	S63
8	146015151	146017972	ENSG00000161016.11	30	73	103	-1.28293396327	SG040	S50
16	70147529	70195203	ENSG00000090857.9	210	64	274	1.7142455176700002	SG041	S58
5	133450402	133483920	ENSG00000081059.15	27	4	31	2.7548875021599994	SG006	S28
12	63359095	63359764	ENSG00000139239.6	18	0	18	inf	SG002	S7
19	18283972	18288927	ENSG00000216490.3	1243	1557	2800	-0.324942648027	SG037	S78
3	47892182	48130769	ENSG00000047849.17	139	215	354	-0.629251776866	SG045	S56
12	112337067	112340042	ENSG00000229186.3	17	2	19	3.08746284125	SG038	S52
21	47706251	47717665	ENSG00000182362.9	24	63	87	-1.39231742278	SG021	S14
4	4861393	4865663	ENSG00000163132.6	25	83	108	-1.73118324157	SG155	S19
X	53559057	53713673	ENSG00000086758.11	41	14	55	1.5501970825600002	SG022	S11
21	43791999	43816955	ENSG00000160183.9	5	121	126	-4.5969351423900005	SG031	S46
5	42756903	42802462	ENSG00000198865.5	19	0	19	inf	SG152	S68
19	6426048	6433790	ENSG00000181240.9	0	12	12	-inf	SG040	S73
19	16177831	16213813	ENSG00000167460.10	258	164	422	0.653675250805	SG149	S66
2	187350883	187374090	ENSG00000065548.13	19	3	22	2.66296501272	SG152	S68
3	122399465	122449687	ENSG00000173193.9	872	1135	2007	-0.380292257401	SG041	S59
17	25621102	25640657	ENSG00000109046.10	556	421	977	0.401264649657	SG040	S49
11	7260009	7490273	ENSG00000170743.12	64	19	83	1.75207248656	SG024	S13
1	11796141	11814859	ENSG00000177674.11	32	67	99	-1.06608919046	SG149	S90
8	144989321	145050902	ENSG00000178209.10	511	386	897	0.40472244367	SG148	S67
7	37960163	37991543	ENSG00000086289.7	45	16	61	1.49185309633	SG022	S11
7	64139332	64147771	ENSG00000271550.1	7	45	52	-2.68449817427	SG151	S64
17	21279509	21323179	ENSG00000184185.5	49	12	61	2.02974734339	SG149	S66
6	57179603	57513375	ENSG00000146143.13	55	7	62	2.97400479147	SG003	S27
19	18169805	18209754	ENSG00000096996.11	107	61	168	0.810729648838	SG011	S9
9	19375995	19380252	ENSG00000137154.8	135	61	196	1.14607825949	SG040	S73
X	40507558	40595110	ENSG00000180182.6	39	4	43	3.28540221886	SG031	S23
6	53132196	53213947	ENSG00000012660.9	20	57	77	-1.51096191928	SG001	S1
3	40351175	40353915	ENSG00000114784.3	21	63	84	-1.58496250072	SG030	S20
11	5710919	5757680	ENSG00000132274.11	837	1009	1846	-0.269626646556	SG155	S19
17	3575493	3599698	ENSG00000083454.17	26	73	99	-1.48938484074	SG027	S22
6	86159809	86205500	ENSG00000135318.7	13	0	13	inf	SG026	S17
11	5684425	5959849	ENSG00000132256.14	1344	1604	2948	-0.255141003676	SG041	S59
4	75858305	75975325	ENSG00000169116.7	143	71	214	1.0101242172700002	SG002	S72
1	39997510	40024379	ENSG00000243970.1	0	16	16	-inf	SG038	S52
16	56485402	56513012	ENSG00000087263.12	28	62	90	-1.14684138833	SG045	S79
1	160765864	160798051	ENSG00000122224.13	165	236	401	-0.516320835116	SG040	S49
12	109038885	109125372	ENSG00000110880.6	89	163	252	-0.8729947232649999	SG027	S22
5	175792471	175828866	ENSG00000175414.6	387	252	639	0.618909832644	SG040	S73
12	13080660	13137579	ENSG00000247498.5	1	14	15	-3.80735492206	SG043	S62
2	12857015	12882860	ENSG00000071575.7	36	9	45	2.0	SG038	S53
3	53258723	53290047	ENSG00000163931.11	662	809	1471	-0.289308485623	SG025	S33
7	99775186	99818169	ENSG00000066923.13	92	25	117	1.87970576628	SG001	S25
12	120532899	120555306	ENSG00000111737.7	22	51	73	-1.21299372333	SG041	S59
14	50085237	50087403	ENSG00000165502.6	31	8	39	1.95419631039	SG003	S2
X	129003040	129091504	ENSG00000235189.1	42	0	42	inf	SG152	S68
2	105713510	105719402	ENSG00000231851.1	76	135	211	-0.828888083607	SG027	S44
6	86370710	86388451	ENSG00000203875.6	501	78	579	2.68326457433	SG026	S17
19	9523272	9546254	ENSG00000174652.13	62	118	180	-0.928446738975	SG006	S4
1	31902192	31902614	ENSG00000268950.1	90	27	117	1.73696559417	SG003	S2
3	196669494	196670411	ENSG00000270170.1	72	21	93	1.77760757866	SG150	S93
1	155286654	155291478	ENSG00000225855.2	6	27	33	-2.16992500144	SG151	S88
14	107178820	107179338	ENSG00000211974.2	92	5	97	4.20163386117	SG026	S18
7	22157856	22396763	ENSG00000136237.14	28	71	99	-1.3423921974500002	SG040	S49
11	7260009	7490273	ENSG00000170743.12	69	15	84	2.20163386117	SG025	S34
11	86013253	86056969	ENSG00000149196.11	0	15	15	-inf	SG151	S65
9	6645956	6670635	ENSG00000236924.1	9	31	40	-1.7842713089400002	SG024	S13
22	17618401	17646158	ENSG00000069998.8	10	43	53	-2.10433665981	SG043	S61
5	57749809	57756087	ENSG00000145632.10	4	42	46	-3.39231742278	SG043	S61
22	37678068	37711382	ENSG00000100055.16	58	127	185	-1.13070369164	SG150	S92
5	138906016	139008018	ENSG00000131508.11	27	59	86	-1.1277555472	SG024	S37
17	74136646	74150731	ENSG00000267128.1	51	21	72	1.28010791919	SG150	S92
11	11292423	11643552	ENSG00000110328.5	28	8	36	1.80735492206	SG148	S67
19	18683418	18718551	ENSG00000006016.6	802	596	1398	0.428289905993	SG040	S73
5	6599352	6633404	ENSG00000037474.10	153	72	225	1.08746284125	SG031	S23
1	62660503	62678000	ENSG00000240563.1	11	0	11	inf	SG039	S74
11	43851259	43902276	ENSG00000246250.2	86	136	222	-0.6611980865479999	SG038	S52
X	148558521	148602635	ENSG00000010404.13	25	203	228	-3.02147972741	SG022	S35
17	36891298	36904631	ENSG00000056661.9	79	40	119	0.98185265329	SG069	S47
16	3415099	3536960	ENSG00000262621.2	88	49	137	0.8447217745219999	SG152	S68
16	2961938	3001209	ENSG00000059122.12	113	234	347	-1.0501857571700002	SG038	S52
19	55550476	55582659	ENSG00000160439.11	100	47	147	1.0892673381	SG152	S70
1	16944751	16961054	ENSG00000215908.5	133	83	216	0.680243004154	SG003	S2
1	247460714	247495148	ENSG00000162714.8	133	192	325	-0.52968006522	SG042	S60
10	134000404	134019280	ENSG00000151640.8	0	34	34	-inf	SG002	S31
6	155316488	155578642	ENSG00000146426.13	35	76	111	-1.1186444965	SG023	S96
19	2071037	2096331	ENSG00000172081.9	312	182	494	0.777607578664	SG025	S10
7	6500712	6522220	ENSG00000136240.5	131	209	340	-0.673936130543	SG022	S35
8	80947103	81143467	ENSG00000076554.11	49	93	142	-0.924448966993	SG040	S50
6	130686879	130764208	ENSG00000164484.7	4	34	38	-3.08746284125	SG038	S52
2	25016252	25045245	ENSG00000138092.6	18	53	71	-1.55799545312	SG043	S61
6	139561198	139613276	ENSG00000164440.10	6	27	33	-2.16992500144	SG041	S58
6	166733216	166756079	ENSG00000198818.5	268	193	461	0.47363215319	SG024	S37
6	37600284	37667082	ENSG00000112139.10	1	39	40	-5.28540221886	SG031	S95
X	47305278	47342345	ENSG00000147124.8	27	3	30	3.16992500144	SG046	S57
3	12938719	13114617	ENSG00000144711.9	167	266	433	-0.671578143027	SG030	S20
2	25600067	25896503	ENSG00000138101.14	207	93	300	1.15432814639	SG006	S28
20	57556263	57570188	ENSG00000101158.8	236	162	398	0.542793046477	SG148	S71
17	5264258	5322960	ENSG00000108559.7	649	518	1167	0.325266380313	SG150	S69
19	3630181	3700477	ENSG00000186111.4	54	114	168	-1.078002512	SG001	S1
15	75128457	75135538	ENSG00000140474.8	41	78	119	-0.927850214244	SG027	S44
2	62296582	62364740	ENSG00000229839.2	30	62	92	-1.0473057147799998	SG022	S35
22	50686121	50700254	ENSG00000188130.9	140	209	349	-0.578076115136	SG045	S56
17	16826229	16838153	ENSG00000128438.6	331	482	813	-0.5422019294229999	SG027	S45
5	96149731	96271097	ENSG00000247121.2	819	249	1068	1.7177177095700005	SG041	S59
14	106320349	106322323	ENSG00000211899.3	5366	2227	7593	1.2687454964700002	SG025	S33
16	12654613	12704901	ENSG00000259899.1	365	494	859	-0.436614577817	SG041	S59
7	116451124	116562103	ENSG00000198898.8	188	109	297	0.786404526901	SG041	S58
1	213123862	213165379	ENSG00000143494.11	70	24	94	1.54432051622	SG044	S86
11	57308979	57318108	ENSG00000214872.4	4	21	25	-2.39231742278	SG039	S51
22	37521878	37571094	ENSG00000100385.9	242	159	401	0.60598028199	SG037	S77
15	34671272	34880704	ENSG00000175265.13	55	117	172	-1.08900500606	SG155	S41
3	40498783	40503861	ENSG00000188846.9	312	521	833	-0.7397373434160001	SG041	S59
17	17115526	17140496	ENSG00000154803.8	27	59	86	-1.1277555472	SG021	S14
X	47305278	47342345	ENSG00000147124.8	21	1	22	4.3923174227800015	SG022	S11
X	118749687	118827333	ENSG00000125354.18	6	64	70	-3.41503749928	SG046	S57
12	120634489	120639038	ENSG00000089157.11	73	36	109	1.01989955744	SG038	S76
14	59100685	59115039	ENSG00000165617.10	13	50	63	-1.94341647163	SG042	S83
17	40610862	40674629	ENSG00000033627.10	71	34	105	1.06228427825	SG042	S83
20	62665697	62671315	ENSG00000196421.3	187	1	188	7.54689445989	SG043	S61
19	20718631	20748615	ENSG00000237440.4	62	27	89	1.19930880822	SG041	S59
X	48886242	48901012	ENSG00000068323.12	3	74	77	-4.62449086491	SG152	S70
22	22311397	22337213	ENSG00000100038.15	57	112	169	-0.974464907893	SG148	S67
12	102090725	102137918	ENSG00000111666.6	6	27	33	-2.16992500144	SG022	S12
4	5749811	5894785	ENSG00000072832.10	22	73	95	-1.7303929402400002	SG046	S80
11	289138	296107	ENSG00000142102.11	159	296	455	-0.8965704103450001	SG045	S56
17	5095379	5151364	ENSG00000261879.1	434	705	1139	-0.699928214842	SG038	S53
16	89154783	89222254	ENSG00000176715.11	101	163	264	-0.690516671479	SG151	S65
6	12514342	12515006	ENSG00000212802.3	121	0	121	inf	SG046	S57
6	57179603	57513375	ENSG00000146143.13	5	37	42	-2.88752527074	SG046	S80
20	60758085	60778624	ENSG00000101181.13	63	106	169	-0.750640531063	SG155	S19
3	128444965	128533639	ENSG00000075785.8	55	97	152	-0.818553128662	SG040	S50
14	107078373	107078869	ENSG00000211968.2	106	5	111	4.405992359680001	SG022	S11
12	63359095	63359764	ENSG00000139239.6	26	0	26	inf	SG046	S80
9	137533620	137736686	ENSG00000130635.11	288	508	796	-0.8187596853300001	SG045	S79
13	46916139	46964177	ENSG00000102445.14	67	29	96	1.20810819533	SG002	S72
X	69664711	69725337	ENSG00000082458.7	26	5	31	2.37851162325	SG022	S35
7	134777115	134855547	ENSG00000122783.12	740	533	1273	0.4733897377570001	SG042	S84
2	68592305	68624585	ENSG00000115956.9	818	964	1782	-0.236932303288	SG027	S44
11	63340667	63384355	ENSG00000176485.6	36	10	46	1.84799690655	SG038	S53
X	49091927	49106896	ENSG00000101997.8	39	8	47	2.28540221886	SG038	S53
2	190306159	190340291	ENSG00000115368.5	135	82	217	0.7192635924330001	SG148	S94
17	3575493	3599698	ENSG00000083454.17	87	527	614	-2.5987156557900004	SG155	S19
7	1200121	1204903	ENSG00000229043.2	89	29	118	1.61775243584	SG002	S31
9	137533620	137736686	ENSG00000130635.11	292	165	457	0.8235023446340001	SG024	S36
8	124428965	124479470	ENSG00000156795.2	154	102	256	0.594361198723	SG043	S85
2	37375673	37376447	ENSG00000224891.1	1	14	15	-3.80735492206	SG151	S88
15	91445448	91465814	ENSG00000196547.10	74	124	198	-0.744742944758	SG022	S12
4	25749055	25865382	ENSG00000091490.6	138	50	188	1.464668267	SG023	S96
7	39605975	39649919	ENSG00000241127.3	46	19	65	1.27563444261	SG151	S64
13	43460524	43566385	ENSG00000133106.10	45	108	153	-1.2630344058299998	SG002	S31
19	35810164	35838258	ENSG00000012124.10	352	470	822	-0.417085327928	SG002	S7
13	43597339	43683045	ENSG00000120675.4	48	149	197	-1.63420601974	SG003	S2
17	49242796	49249108	ENSG00000243678.7	502	357	859	0.491763289922	SG038	S76
15	81451916	81601393	ENSG00000172349.12	102	177	279	-0.795180208112	SG150	S69
19	49990811	49995565	ENSG00000142541.12	1919	2321	4240	-0.274391811149	SG025	S10
15	31619058	31727868	ENSG00000169926.5	268	194	462	0.466176348271	SG151	S64
3	47892182	48130769	ENSG00000047849.17	152	219	371	-0.526859546158	SG148	S94
1	213025450	213031430	ENSG00000198468.3	34	9	43	1.91753783981	SG025	S34
8	144063155	144099854	ENSG00000247317.3	23	4	27	2.52356195606	SG040	S50
3	98451099	98540045	ENSG00000064225.8	14	39	53	-1.4780472968	SG027	S45
X	73012040	73048902	ENSG00000270641.1	171	27	198	2.66296501272	SG031	S23
12	120634489	120639038	ENSG00000089157.11	16	0	16	inf	SG007	S30
19	49375649	49379314	ENSG00000087074.7	1178	923	2101	0.351936986185	SG149	S90
5	175810949	175815976	ENSG00000048162.15	300	172	472	0.802553935794	SG040	S49
6	6144318	6321246	ENSG00000124491.11	1	15	16	-3.90689059561	SG037	S78
X	57002803	57021970	ENSG00000204271.6	2	19	21	-3.2479275134400005	SG007	S30
16	2961938	3001209	ENSG00000059122.12	141	68	209	1.05208851115	SG040	S50
19	22235254	22274282	ENSG00000197134.7	23	4	27	2.52356195606	SG040	S50
X	46464753	46618490	ENSG00000065923.5	19	65	84	-1.77444029958	SG007	S6
12	133200348	133263945	ENSG00000177084.12	272	171	443	0.669610326364	SG001	S25
17	49242796	49249108	ENSG00000243678.7	197	289	486	-0.552873863044	SG023	S39
17	70422080	70424993	ENSG00000263680.2	97	37	134	1.3904594765600002	SG022	S11
8	98787285	98865241	ENSG00000104341.12	13	55	68	-2.08091999538	SG045	S55
11	236546	252981	ENSG00000185627.13	327	453	780	-0.470220414548	SG151	S64
20	361261	378203	ENSG00000101255.6	102	158	260	-0.631355406206	SG006	S4
17	30819540	31204195	ENSG00000176658.12	99	54	153	0.874469117916	SG155	S19
19	41903385	41930910	ENSG00000248098.6	235	103	338	1.19001641938	SG027	S44
1	213031597	213072705	ENSG00000162769.8	63	113	176	-0.842899038915	SG069	S48
16	1494935	1525581	ENSG00000103249.13	291	178	469	0.7091419119419999	SG024	S13
12	104359582	104382652	ENSG00000139372.10	19	0	19	inf	SG030	S43
3	150458914	150481264	ENSG00000181788.3	70	21	91	1.73696559417	SG040	S49
1	111415775	111442550	ENSG00000143119.8	717	953	1670	-0.4105030952080001	SG042	S60
9	137533620	137736686	ENSG00000130635.11	241	166	407	0.537849904883	SG041	S59
11	125439112	125454575	ENSG00000149547.10	117	66	183	0.8259706002249999	SG003	S27
2	231191899	231268447	ENSG00000185404.12	116	176	292	-0.60145062351	SG046	S80
11	2397407	2418649	ENSG00000110651.7	7	31	38	-2.14684138833	SG151	S65
22	35653445	35691800	ENSG00000100281.9	31	69	100	-1.15432814639	SG042	S84
6	133135580	133138703	ENSG00000112306.7	1444	1654	3098	-0.195888492284	SG038	S52
8	29190581	29208185	ENSG00000120875.4	227	148	375	0.617095121662	SG025	S33
X	114795501	114885181	ENSG00000102024.13	27	0	27	inf	SG152	S68
3	52558512	52569070	ENSG00000168268.6	48	88	136	-0.874469117916	SG041	S82
19	15464196	15490609	ENSG00000105127.4	33	11	44	1.58496250072	SG152	S68
16	85007787	85045141	ENSG00000153786.8	160	245	405	-0.614709844115	SG001	S26
6	6144318	6321246	ENSG00000124491.11	151	292	443	-0.951419819555	SG155	S19
11	47260853	47270457	ENSG00000134575.5	31	67	98	-1.11189288007	SG022	S12
1	169631245	169823221	ENSG00000000460.12	224	139	363	0.6884138493340001	SG069	S24
7	127292234	127732659	ENSG00000197157.6	204	278	482	-0.446515730752	SG021	S38
2	54683422	54896812	ENSG00000115306.11	262	177	439	0.565817451454	SG024	S36
20	43104526	43123244	ENSG00000124120.6	8	35	43	-2.12928301694	SG001	S26
12	4382938	4414516	ENSG00000118971.3	532	428	960	0.3138154491	SG042	S83
4	5749811	5894785	ENSG00000072832.10	36	93	129	-1.36923380967	SG046	S81
22	22781876	22782371	ENSG00000211654.2	20	2	22	3.32192809489	SG041	S58
16	420773	434396	ENSG00000129925.6	153	225	378	-0.556393348524	SG040	S73
1	7844380	7905237	ENSG00000049246.10	2	18	20	-3.16992500144	SG046	S57
18	47013709	47018248	ENSG00000265496.2	43	93	136	-1.11289405641	SG002	S7
21	43791999	43816955	ENSG00000160183.9	7	71	78	-3.34239219745	SG155	S42
11	7260009	7490273	ENSG00000170743.12	39	9	48	2.11547721742	SG027	S22
19	4838423	4867780	ENSG00000105355.4	159	17	176	3.22542011403	SG042	S60
22	42321045	42322822	ENSG00000159958.3	328	244	572	0.426814667055	SG152	S91
20	61584052	61599949	ENSG00000101194.13	550	417	967	0.399384234967	SG150	S92
22	38879453	38903665	ENSG00000100201.14	588	416	1004	0.499232626695	SG041	S82
19	50433021	50437192	ENSG00000169136.4	770	253	1023	1.60572106089	SG022	S12
7	134777115	134855547	ENSG00000122783.12	557	400	957	0.477677327565	SG046	S80
10	88810243	88854623	ENSG00000148672.7	0	20	20	-inf	SG044	S63
19	16771938	16800840	ENSG00000072954.2	62	113	175	-0.8659826520280001	SG025	S33
2	231033634	231090444	ENSG00000135899.12	189	319	508	-0.7551701895440001	SG045	S79
6	167342992	167370672	ENSG00000026297.11	1056	1231	2287	-0.221220927126	SG151	S65
14	106202680	106209408	ENSG00000211896.2	0	41	41	-inf	SG002	S7
3	124801480	124931708	ENSG00000221955.6	320	210	530	0.6076825772209999	SG149	S66
8	98787285	98865241	ENSG00000104341.12	5	25	30	-2.32192809489	SG027	S45
1	22351681	22357716	ENSG00000218510.3	66	154	220	-1.22239242134	SG069	S47
10	43881065	43904614	ENSG00000169813.12	96	155	251	-0.6911619045530001	SG027	S45
20	23608534	23619110	ENSG00000101439.4	44	104	148	-1.2410080995	SG044	S86
6	168227602	168372703	ENSG00000130396.16	89	41	130	1.11818142635	SG011	S32
3	127770484	127790526	ENSG00000058262.5	557	449	1006	0.310961882599	SG046	S80
22	37611778	37611931	ENSG00000226233.1	20	2	22	3.32192809489	SG023	S96
11	67273968	67276102	ENSG00000167797.3	99	42	141	1.2370391973	SG038	S53
4	778745	819986	ENSG00000168993.10	36	11	47	1.7104933828100002	SG152	S68
13	43460524	43566385	ENSG00000133106.10	185	49	234	1.9166716164	SG025	S33
19	17186591	17325346	ENSG00000099331.9	638	489	1127	0.383721958813	SG025	S34
14	95873606	95876427	ENSG00000229645.4	38	14	52	1.44057259139	SG150	S69
1	207101863	207119811	ENSG00000162896.5	47	125	172	-1.4111954329799998	SG155	S19
18	10670238	11148587	ENSG00000154864.7	25	3	28	3.05889368905	SG021	S15
3	53258723	53290047	ENSG00000163931.11	556	716	1272	-0.364874704541	SG006	S29
1	171750788	171783163	ENSG00000010165.15	104	178	282	-0.775293712825	SG026	S18
X	39909068	40036582	ENSG00000183337.12	18	1	19	4.16992500144	SG046	S81
1	236681300	236716281	ENSG00000116977.14	760	469	1229	0.6964114958159999	SG031	S46
4	187025573	187093821	ENSG00000109794.9	37	10	47	1.88752527074	SG046	S81
17	21279509	21323179	ENSG00000184185.5	6	27	33	-2.16992500144	SG040	S73
8	79578282	79632000	ENSG00000104427.7	9	33	42	-1.87446911792	SG021	S38
X	153172821	153193873	ENSG00000089820.11	276	68	344	2.02106161553	SG031	S95
19	22235254	22274282	ENSG00000197134.7	21	2	23	3.39231742278	SG040	S73
7	44084239	44109055	ENSG00000136279.14	176	258	434	-0.551795636786	SG155	S42
17	25621102	25640657	ENSG00000109046.10	340	459	799	-0.432959407276	SG069	S47
5	180467225	180488523	ENSG00000165810.12	72	1	73	6.16992500144	SG038	S52
2	37477645	37551951	ENSG00000115825.5	40	77	117	-0.944858445808	SG043	S85
10	49872244	49880469	ENSG00000236800.1	0	17	17	-inf	SG039	S51
19	58897767	58906173	ENSG00000083845.4	1190	1442	2632	-0.277109591046	SG027	S44
5	95860971	96115299	ENSG00000153113.19	229	129	358	0.827976532674	SG027	S44
12	63359095	63359764	ENSG00000139239.6	0	20	20	-inf	SG030	S43
6	86159809	86205500	ENSG00000135318.7	1	14	15	-3.80735492206	SG007	S6
3	124480795	124620265	ENSG00000082781.7	16	2	18	3.0	SG151	S65
11	289138	296107	ENSG00000142102.11	76	151	227	-0.990477225881	SG022	S11
14	105391153	105399574	ENSG00000166428.8	61	3	64	4.34577483684	SG007	S6
2	101624079	101869263	ENSG00000204634.8	50	17	67	1.55639334852	SG148	S94
5	123972608	124084500	ENSG00000168916.11	25	6	31	2.05889368905	SG155	S42
8	11351510	11422113	ENSG00000136573.8	299	873	1172	-1.5458361694299998	SG149	S66
2	242673994	242708226	ENSG00000180902.12	129	235	364	-0.8652896911419999	SG069	S47
1	85391268	85462796	ENSG00000153898.8	400	673	1073	-0.7506065048360001	SG041	S58
14	74551499	74667936	ENSG00000205659.6	53	19	72	1.47999294112	SG022	S11
